khushboo	खुशबू
khushbuu	खुशबू
khushbu	खुशबू
khusbhu	खुशबू
tera	तेरा
teraa	तेरा
thera	तेरा
teraaa	तेरा
badan	बदन
sulgeh	सुलगे
sulage	सुलगे
sulge	सुलगे
mehke	महके
mahake	महके
mehake	महके
maheke	महके
pighale	पिघले
pighle	पिघले
dehke	दहके
dahake	दहके
behke	बहके
baheke	बहके
bahake	बहके
behake	बहके
bahke	बहके
mera	मेरा
meraa	मेरा
meraaa	मेरा
chali	चली
chalii	चली
challi	चली
chale	चली
hawaa	हवा
hawa	हवा
hava	हवा
havaa	हवा
ke	के
kee	के
kaee	के
koee	के
kie	के
khe	के
que	के
koe	के
nasha	नशा
ghula	घुला
gula	घुला
ghulaa	घुला
samaa	समा
sama	समा
samah	समा
saman	समा
samma	समा
samaan	समा
samay	समा
bhi	भी
bas	भी
jaise	जैसे
jise	जैसे
dhuan	धुआँ
dhuaan	धुआँ
roop	रूप
ruup	रूप
rup	रूप
ruupa	रूप
rupa	रूप
ye	ये
yye	ये
yei	ये
yey	ये
khule	खुले
khulke	खुले
baal	बाल
bal	बाल
hain	हैं
hai	हैं
hii	हैं
hein	हैं
haan	हैं
huye	हैं
huyee	हैं
huii	हैं
haye	हैं
badliyaan	बदलियाँ
badaliyaan	बदलियाँ
badliyan	बदलियाँ
badaliyan	बदलियाँ
tu	तू
to	तू
jo	जो
jaao	जो
jao	जो
paas	पास
pass	पास
pas	पास
pyaas	पास
paasa	पास
pyaase	पास
mujhe	मुझे
muze	मुझे
mujhse	मुझे
mujeh	मुझे
mujh	मुझे
muhje	मुझे
mujhey	मुझे
muzhe	मुझे
muhjhe	मुझे
mujkhe	मुझे
pyaas	प्यास
pyas	प्यास
payaas	प्यास
pyaasaa	प्यास
paas	प्यास
tere	तेरे
tera	तेरे
teraa	तेरे
teree	तेरे
terre	तेरे
terey	तेरे
teere	तेरे
tehre	तेरे
ka	का
kya	का
kaa	का
kar	का
khat	का
kal	का
kyaa	का
kam	का
kab	का
kah	का
kat	का
kaam	का
kan	का
khai	का
kai	का
ahsaas	एहसास
ehsaas	एहसास
ahasaas	एहसास
ehasaas	एहसास
ehsas	एहसास
ahsas	एहसास
yehasaas	एहसास
aihsaas	एहसास
ehasas	एहसास
chaand	चाँद
chand	चाँद
chaanda	चाँद
chhaai	चाँद
chanad	चाँद
chhaand	चाँद
sitaare	सितारे
sitare	सितारे
sithaare	सितारे
sitaaren	सितारे
sitarey	सितारे
seetaare	सितारे
sitaren	सितारे
karate	करते
karte	करते
kaarte	करते
karthe	करते
ishaare	इशारे
ishare	इशारे
ishaaren	इशारे
ham	हम
hum	हम
hama	हम
hmm	हम
hame	हम
hume	हम
hm	हम
humi	हम
hami	हम
tumhaare	तुम्हारे
tumhare	तुम्हारे
thumharee	तुम्हारे
tumhaaraa	तुम्हारे
tumhaara	तुम्हारे
tumhaaree	तुम्हारे
tumahaare	तुम्हारे
tum	तुम
tuma	तुम
thum	तुम
ho	हो
hoo	हो
huh	हो
had	हो
heh	हो
hamaare	हमारे
hamare	हमारे
humare	हमारे
hamaari	हमारे
humaare	हमारे
humari	हमारे
hamara	हमारे
hamarey	हमारे
humhare	हमारे
aao	आओ
awo	आओ
mila	मिला
milaa	मिला
milaao	मिला
milay	मिला
mela	मिला
len	लें
lein	लें
nigaahen	निगाहें
nigaahein	निगाहें
nigahein	निगाहें
nigaahe	निगाहें
nigahen	निगाहें
nigahaen	निगाहें
nigahe	निगाहें
hamen	हमें
hume	हमें
hamein	हमें
humein	हमें
hame	हमें
humen	हमें
humeein	हमें
humey	हमें
hmein	हमें
hamey	हमें
hamain	हमें
chaaho	चाहो
chaho	चाहो
tumhen	तुम्हें
tumhein	तुम्हें
tumhey	तुम्हें
chaahen	चाहें
chaahe	चाहें
chahe	चाहें
chahein	चाहें
chaahein	चाहें
chahen	चाहें
pyaar	प्यार
pyar	प्यार
paar	प्यार
paayar	प्यार
par	प्यार
payar	प्यार
pyaara	प्यार
piyaao	प्यार
pyara	प्यार
pyaasa	प्यार
pyaa	प्यार
paaya	प्यार
dil	दिल
dila	दिल
dill	दिल
dhil	दिल
dilo	दिल
pukaare	पुकारे
pukare	पुकारे
aankhon	आँखों
aankhone	आँखों
ankhon	आँखों
ankho	आँखों
aakhon	आँखों
aankho	आँखों
aankhoon	आँखों
annkhon	आँखों
aankkhon	आँखों
ankhoon	आँखों
aakho	आँखों
aakhoon	आँखों
aankon	आँखों
aankhonn	आँखों
men	में
mein	में
meein	में
maein	में
menu	में
masti	मस्ती
mastii	मस्ती
husn	हुस्न
husna	हुस्न
husno	हुस्न
husne	हुस्न
pyaara	प्यारा
pyara	प्यारा
pyaaraa	प्यारा
dekha	देखा
dekhaa	देखा
dekhna	देखा
dekhka	देखा
dehka	देखा
jab	जब
jaba	जब
se	से
see	से
jalava	जलवा
jalawa	जलवा
jalwa	जलवा
jalavaa	जलवा
jalawaa	जलवा
jalva	जलवा
jalvaa	जलवा
tumhaara	तुम्हारा
tumhaaraa	तुम्हारा
tumhara	तुम्हारा
rahen	रहें
rahein	रहें
rahey	रहें
rangeen	रंगीं
rangin	रंगीं
rangee	रंगीं
rangiin	रंगीं
nazaare	नज़ारे
nazare	नज़ारे
najaare	नज़ारे
nazarey	नज़ारे
nazaaren	नज़ारे
najare	नज़ारे
hi	ही
hai	ही
hii	ही
hee	ही
he	ही
hue	ही
hui	ही
muskuraaye	मुस्कुराये
muskuraye	मुस्कुराये
muskurayein	मुस्कुराये
hamaari	हमारी
humaaree	हमारी
hameare	हमारी
hamaare	हमारी
humaari	हमारी
hamari	हमारी
hamaarii	हमारी
humari	हमारी
hamaaree	हमारी
vafaaen	वफ़ाएं
wafaen	वफ़ाएं
wafayein	वफ़ाएं
vafaayen	वफ़ाएं
vafaen	वफ़ाएं
wafaayen	वफ़ाएं
wafayen	वफ़ाएं
rah	रह
raha	रह
reh	रह
reha	रह
rehe	रह
rahe	रह
rahi	रह
aaen	आएं
lab	लब
lub	लब
labh	लब
labo	लब
par	पर
per	पर
para	पर
duaaen	दुआएं
duaayen	दुआएं
duaen	दुआएं
duaein	दुआएं
dhuayen	दुआएं
duyaen	दुआएं
kabhi	कभी
n	न
chalen	चलें
chalein	चलें
chaley	चलें
manva	मनवा
manava	मनवा
manavaa	मनवा
manawaa	मनवा
manwa	मनवा
manvaa	मनवा
manawa	मनवा
more	मोरे
door	दूर
dur	दूर
duur	दूर
durr	दूर
daur	दूर
duurr	दूर
re	रे
ree	रे
saagar	सागर
sagar	सागर
chhor	छोर
chor	छोर
haan	हाँ
haa	हाँ
hawa	हाँ
han	हाँ
hara	हाँ
hain	हाँ
haai	हाँ
hahn	हाँ
haaan	हाँ
haay	हाँ
ambar	अम्बर
amber	अम्बर
ambara	अम्बर
or	ओर
ore	ओर
kshitij	क्षितिज
bane	बने
baney	बने
banne	बने
jahaan	जहाँ
jahan	जहाँ
jahaa	जहाँ
jaahaan	जहाँ
jahaann	जहाँ
jahhan	जहाँ
jehan	जहाँ
zehan	जहाँ
baadal	बादल
badal	बादल
jhuke	झुके
ghor	घोर
angana	अँगना
angna	अँगना
anganaa	अँगना
deep	दीप
dip	दीप
diip	दीप
bani	बनी
banii	बनी
taaron	तारों
taron	तारों
taaro	तारों
ki	की
kii	की
koi	की
key	की
khi	की
kay	की
paanti	पाँती
hui	हुई
huyi	हुई
huii	हुई
huwi	हुई
huye	हुई
huvi	हुई
kalpana	कल्पना
laga	लगा
lagaa	लगा
lagtaa	लगा
lagta	लगा
ude	उड़े
nithur	निठुर
bada	बड़ा
badaa	बड़ा
badha	बड़ा
haay	हाय
hai	हाय
hay	हाय
haaye	हाय
haaya	हाय
haye	हाय
haai	हाय
huay	हाय
haiy	हाय
jagat	जगत
jagata	जगत
mere	मेरे
mera	मेरे
meree	मेरे
meraa	मेरे
merey	मेरे
sapane	सपने
sapne	सपने
sapanen	सपने
kare	करे
karey	करे
karen	करे
choor	चूर
chuur	चूर
chur	चूर
mora	मोरा
moraa	मोरा
jeevan	जीवन
jiivan	जीवन
jiwan	जीवन
jeewan	जीवन
jivan	जीवन
jeeven	जीवन
jivana	जीवन
jiiwan	जीवन
jeeivan	जीवन
jiivana	जीवन
mukt	मुक्त
bahe	बहे
baahe	बहे
ga	गा
gan	गा
gaa	गा
gam	गा
jaao	जाओ
jao	जाओ
jaayo	जाओ
jaavo	जाओ
aasaavari	आसावरी
bhramar	भ्रमर
gunja	गुंज
naachen	नाचें
naachein	नाचें
naache	नाचें
nachein	नाचें
mor	मोर
mora	मोर
more	मोर
moor	मोर
o	ओ
sundar	सुन्दर
sunder	सुन्दर
khile	खिले
khilen	खिले
khiley	खिले
hile	खिले
aasha	आशा
asha	आशा
ashaa	आशा
aisaa	आशा
nitya	नित्य
naye	नये
mori	मोरी
moree	मोरी
morii	मोरी
more	मोरी
bagiya	बगिया
bagiyaa	बगिया
bagiyaan	बगिया
bhagiya	बगिया
sada	सदा
sadaa	सदा
sadha	सदा
sadai	सदा
basant	बसन्त
bahaar	बहार
bahar	बहार
bahaara	बहार
bhari	बहार
baahar	बहार
bahaare	बहार
kaala	काला
kala	काला
kaalaa	काला
koyal	कोयल
koyala	कोयल
kaali	काली
kaalee	काली
kaalii	काली
kali	काली
kalee	काली
kaale	काली
us	उस
uss	उस
use	उस
usse	उस
raat	रात
raath	रात
raata	रात
rat	रात
rasta	रात
zulf	ज़ुल्फ़
teri	तेरी
tere	तेरी
terii	तेरी
teree	तेरी
theri	तेरी
saavan	सावन
saawan	सावन
sawan	सावन
savan	सावन
saavana	सावन
saavn	सावन
hamaraaz	हमराज़
hamraaz	हमराज़
humaraz	हमराज़
humraaz	हमराज़
humaraaj	हमराज़
bela	बेला
belaa	बेला
gora	गोरा
goraa	गोरा
juhi	जुही
gori	गोरी
gorii	गोरी
goree	गोरी
goriye	गोरी
gore	गोरी
chaandani	चाँदनी
chandni	चाँदनी
chaandni	चाँदनी
chaandanii	चाँदनी
chandini	चाँदनी
chandani	चाँदनी
chaandhni	चाँदनी
chaadani	चाँदनी
mukhada	मुखड़ा
mukhadaa	मुखड़ा
mukhda	मुखड़ा
mukhdaa	मुखड़ा
jis	जिस
jise	जिस
jaisi	जिस
jism	जिस
jisa	जिस
pe	पे
mujhako	मुझको
mujhko	मुझको
muhjko	मुझको
mujko	मुझको
mujjhko	मुझको
mujhuko	मुझको
mujkho	मुझको
naaz	नाज़
naz	नाज़
naj	नाज़
nila	नीला
neela	नीला
niilaa	नीला
neelaa	नीला
niila	नीला
nilaa	नीला
nili	नीली
neeli	नीली
niilii	नीली
nil	नील
niil	नील
kamal	कमल
aankhein	आँखें
aankhen	आँखें
aankhey	आँखें
aakhein	आँखें
aakhen	आँखें
ankhen	आँखें
aankein	आँखें
jin	जिन
gahara	गहरा
gaharaa	गहरा
gahraa	गहरा
gahera	गहरा
gehra	गहरा
gehara	गहरा
gehraa	गहरा
raaz	राज़
raz	राज़
raj	राज़
raaze	राज़
sur	सुर
mitha	मीठा
lay	लय
mithi	मीठी
mitti	मीठी
miti	मीठी
raagini	रागिनी
rangini	रागिनी
raaginii	रागिनी
raagani	रागिनी
raginee	रागिनी
mithe	मीठे
honth	होंठ
hont	होंठ
hooth	होंठ
hot	होंठ
hoont	होंठ
hoot	होंठ
kahin	कहीं
kahee	कहीं
kaheen	कहीं
kahiin	कहीं
kahii	कहीं
kahie	कहीं
kahina	कहीं
aanchal	आँचल
aachal	आँचल
anchal	आँचल
aanchala	आँचल
gulabi	गुलाबी
gulaabi	गुलाबी
gulabee	गुलाबी
gulaabii	गुलाबी
gulaabee	गुलाबी
chaal	चाल
chal	चाल
chaala	चाल
chali	चाल
aankh	आँख
ankh	आँख
aake	आँख
aakh	आँख
jaadu	जादू
jaaduu	जादू
jadoo	जादू
jaado	जादू
jadu	जादू
jaadoo	जादू
jadhoo	जादू
jism	जिस्म
jismo	जिस्म
narm	नर्म
baahein	बाहें
baahen	बाहें
baahe	बाहें
baanhein	बाहें
bahen	बाहें
bahein	बाहें
yahan	यहां
yahaan	यहां
yahaa	यहां
kadam	कदम
laakhon	लाखों
laakho	लाखों
lakho	लाखों
lakhon	लाखों
magar	मगर
dene	देने
dhene	देने
deeney	देने
ladki	लड़की
ladaki	लड़की
ladakii	लड़की
sabse	सबसे
sabase	सबसे
alag	अलग
kitne	कितनी
kitanii	कितनी
kitni	कितनी
kitani	कितनी
kitane	कितनी
ghulti	घुलती
ghulati	घुलती
zaraa	ज़रा
zara	ज़रा
kya	क्या
kyaa	क्या
kaa	क्या
kiyaa	क्या
kiya	क्या
kisey	क्या
kaya	क्या
kasia	क्या
ajeebsi	अजीब
ajeeb	अजीब
ajiib	अजीब
ajib	अजीब
si	सी
se	सी
sii	सी
see	सी
soyi	सी
madhur	मधुर
git	गीत
geet	गीत
giit	गीत
milan	मिलन
milna	मिलन
man	मन
men	मन
taar	तार
tar	तार
taare	तार
thaar	तार
dede	देदे
sandesa	सन्देसा
sandesaa	सन्देसा
sapan	सपन
sapana	सपन
suhaana	सुहाना
suhana	सुहाना
suhaanaa	सुहाना
taraana	तराना
taraanaa	तराना
tarana	तराना
rahun	रहूं
rahuun	रहूं
na	ना
naa	ना
nak	ना
nan	ना
hosh	होश
behosh	बेहोश
bana	बना
banaa	बना
main	मैं
huun	हूँ
hoon	हूँ
hoo	हूँ
hun	हूँ
hui	हूँ
hoy	हूँ
huye	हूँ
hoye	हूँ
hooo	हूँ
hue	हूँ
gaanv	गांव
gaanw	गांव
baabu	बाबू
babu	बाबू
baabuu	बाबू
baaboo	बाबू
rang	रंग
ranga	रंग
rango	रंग
rangi	रंग
lahari	लहरी
lehri	लहरी
padhana	पढ़ना
sikha	सिखा
sikhaa	सिखा
de	दे
baith	बैठ
bait	बैठ
yahaan	यहाँ
yahan	यहाँ
yahaa	यहाँ
yehan	यहाँ
yahana	यहाँ
meri	मेरी
meree	मेरी
merii	मेरी
mere	मेरी
meray	मेरी
raani	रानी
raanii	रानी
rani	रानी
raazi	रानी
tujhako	तुझको
tujhko	तुझको
tujkho	तुझको
tujko	तुझको
tujhiko	तुझको
tuhjko	तुझको
tuzako	तुझको
aaj	आज
aj	आज
padhaa	पढ़ा
padha	पढ़ा
duun	दूँ
don	दूँ
doon	दूँ
doo	दूँ
dun	दूँ
likhaa	लिखा
likha	लिखा
leikha	लिखा
likkha	लिखा
tumko	तुमको
tumako	तुमको
tumakoe	तुमको
tummko	तुमको
lachak	लचक
sikha	सीखा
seekha	सीखा
siikhaa	सीखा
sikhaa	सीखा
seekhaa	सीखा
tujhe	तुझे
tuze	तुझे
tujhey	तुझे
tuje	तुझे
tujhme	तुझे
tujeh	तुझे
tuhje	तुझे
tujhhe	तुझे
tuj	तुझे
maa	माँ
maan	माँ
main	माँ
maaen	माँ
maaja	माँ
maam	माँ
maana	माँ
maao	माँ
maaon	माँ
ne	ने
nae	ने
ney	ने
kahaa	कहा
kaha	कहा
kahan	कहा
mujhase	मुझसे
mujhse	मुझसे
muhjse	मुझसे
mujhese	मुझसे
mujhsey	मुझसे
raste	रस्ते
rishte	रस्ते
raa	रा
ra	रा
raat	रा
la	ल
lo	ल
le	ल
l	ल
laa	ला
la	ला
lag	ला
laal	ला
laaa	ला
chhaae	छाए
chhaye	छाए
chaaye	छाए
chhae	छाए
chaye	छाए
chaahe	छाए
to	तो
too	तो
tho	तो
taxi	तो
barase	बरसे
barse	बरसे
barsen	बरसे
paanii	पानी
paani	पानी
pani	पानी
phaani	पानी
kyuun	क्यूँ
kyun	क्यूँ
kyoun	क्यूँ
kaun	क्यूँ
gayaa	गया
gaya	गया
gya	गया
gayaaa	गया
kahaan	कहाँ
kahan	कहाँ
kahaa	कहाँ
khabar	कहाँ
chehraa	कहाँ
khafa	कहाँ
khayal	कहाँ
chhaa	कहाँ
khahan	कहाँ
khafaa	कहाँ
kahaam	कहाँ
badii	बड़ी
badi	बड़ी
badhi	बड़ी
duniyaa	दुनिया
duniya	दुनिया
duniyaan	दुनिया
duniyase	दुनिया
dhuniyaa	दुनिया
dhuniya	दुनिया
duniyan	दुनिया
dooniya	दुनिया
duniye	दुनिया
duniyaaa	दुनिया
dunya	दुनिया
kitanaa	कितना
kitna	कितना
kitana	कितना
kitnaa	कितना
kitne	कितना
akelaa	अकेला
akela	अकेला
bilkul	बिल्कुल
tuute	टूटे
toote	टूटे
tute	टूटे
tutte	टूटे
khilaunon	खिलौनों
khilauno	खिलौनों
khelaa	खेला
khela	खेला
kaisaa	कैसा
kaisa	कैसा
kiska	कैसा
kairaat	ख़ैरात
hun	हुँ
din	दिन
dina	दिन
ding	दिन
lage	लगे
lagey	लगे
lagge	लगे
lagee	लगे
hasne	हँसने
hansane	हँसने
hasane	हँसने
hansne	हँसने
dekho	देखो
dekko	देखो
deko	देखो
dehko	देखो
dekhko	देखो
basanti	बसंती
basantee	बसंती
hone	होने
sone	सोने
jaisi	जैसी
jaisii	जैसी
rahi	रही
rahe	रही
rahii	रही
rahee	रही
rehi	रही
rehke	रही
har	हर
harr	हर
hara	हर
her	हर
subah	सुबह
subh	सुबह
suboh	सुबह
subha	सुबह
subaah	सुबह
subaha	सुबह
subho	सुबह
subaho	सुबह
ab	अब
abb	अब
gulaal	गुलाल
chalne	चलने
chalane	चलने
lagi	लगी
lagii	लगी
lagee	लगी
lage	लगी
mehki	महकी
mahaki	महकी
mahakii	महकी
mehaki	महकी
mahki	महकी
meheki	महकी
maheki	महकी
mehke	महकी
pawan	पवन
pavan	पवन
pavana	पवन
baawara	बावरा
baavaraa	बावरा
baavraa	बावरा
baavara	बावरा
baavra	बावरा
ud	उड़
uda	उड़
udd	उड़
udh	उड़
chala	चला
chalaa	चला
gagan	गगन
salona	सलोना
salonaa	सलोना
saawala	साँवला
saanvala	साँवला
saanwala	साँवला
machi	मची
machii	मची
naache	नाचे
nache	नाचे
gaaye	गाये
gaye	गाये
maharoom	महरूम
meharuum	महरूम
mehroom	महरूम
kiya	किया
kiyaa	किया
kyaa	किया
kiyakya	किया
ko	को
kho	को
kyo	को
kaza	को
ishaara	इशारा
ishaaraa	इशारा
ishara	इशारा
chalenge	चलेंगे
donon	दोनों
dono	दोनों
sang	संग
sung	संग
sangh	संग
sanng	संग
sanga	संग
saang	संग
koi	कोई
koyi	कोई
khoye	कोई
khou	कोई
khoyi	कोई
khoya	कोई
koye	कोई
samajhe	समझे
samjhe	समझे
samje	समझे
jaane	जाने
jane	जाने
jaan	जाने
jaano	जाने
jagaye	जाने
jaaye	जाने
jalane	जाने
janey	जाने
jaaney	जाने
is	इस
iss	इस
ise	इस
ies	इस
ish	इस
fasaana	फ़साना
fasana	फ़साना
fasaanaa	फ़साना
fasaaana	फ़साना
ya	या
yaa	या
yaar	या
yaad	या
yeah	या
yaya	या
yah	या
yan	या
yaah	या
jaanoon	जानूँ
jaanuun	जानूँ
jaanuri	जानूँ
jaanoo	जानूँ
jaanun	जानूँ
jaane	जानूँ
jaanuu	जानूँ
unako	उनको
unko	उनको
maaloom	मालूम
maalum	मालूम
maaluum	मालूम
malum	मालूम
maloom	मालूम
ik	इक
ek	इक
ika	इक
bataaya	बताया
bataya	बताया
kahi	कही
kahee	कही
baat	बात
bat	बात
baata	बात
baath	बात
baate	बात
baaat	बात
jagamag	जगमग
jagmag	जगमग
zagamag	जगमग
yahi	यही
yahee	यही
yehi	यही
yahii	यही
soi	सोई
soyi	सोई
sooyi	सोई
ummeeden	उम्मीदें
ummiden	उम्मीदें
ummidein	उम्मीदें
ummiiden	उम्मीदें
jaageen	जागीं
jaagin	जागीं
daaman	दामन
daman	दामन
daamann	दामन
dhaman	दामन
choom	चूम
chuum	चूम
chum	चूम
guzare	गुज़रे
guzre	गुज़रे
guzren	गुज़रे
ishq	इश्क़
isq	इश्क़
nafrat	नफ़रत
nafarat	नफ़रत
naam	नाम
nam	नाम
naama	नाम
hamko	हमको
humko	हमको
hamako	हमको
humako	हमको
gumaan	गुमान
sangdil	संगदिल
sangadil	संगदिल
sanam	सनम
sanma	सनम
raah	राह
raha	राह
rah	राह
raaha	राह
raahe	राह
rahe	राह
e	ए
vafaa	वफ़ा
vafa	वफ़ा
wafa	वफ़ा
waffa	वफ़ा
wafaa	वफ़ा
wafaan	वफ़ा
behak	बहक
bahak	बहक
bahek	बहक
behek	बहक
jaaenge	जाएंगे
jayenge	जाएंगे
jaayenge	जाएंगे
jaayeinge	जाएंगे
chhalkega	छलकेगा
chhalakegaa	छलकेगा
zahar	ज़हर
zehar	ज़हर
zeher	ज़हर
zaher	ज़हर
zehr	ज़हर
jaam	जाम
jam	जाम
bewafaa	बेवफ़ा
bevafa	बेवफ़ा
bewafa	बेवफ़ा
bevafaa	बेवफ़ा
bewaafa	बेवफ़ा
jaaey	जाए
jaae	जाए
jae	जाए
jaaye	जाए
jaye	जाए
jaay	जाए
jaane	जाए
jalate	जाए
jaate	जाए
judaye	जाए
jisane	जाए
jaale	जाए
tadap	तड़प
saamna	सामना
saamana	सामना
saamanaa	सामना
samana	सामना
shaam	शाम
sham	शाम
shama	शाम
shamo	शाम
nahin	नहीं
nahiin	नहीं
naheen	नहीं
nahee	नहीं
nahie	नहीं
nahii	नहीं
nahien	नहीं
rokar	रोकर
guzaar	गुज़ार
guzaaar	गुज़ार
goozaar	गुज़ार
dein	दें
den	दें
dey	दें
parchhaee	परछाईं
parachhaain	परछाईं
parchayee	परछाईं
parachhaayin	परछाईं
parchaayi	परछाईं
thokar	ठोकर
maar	मार
marr	मार
mar	मार
mari	मार
muhabbat	मुहब्बत
muhobbat	मुहब्बत
muhhabbat	मुहब्बत
qadam	क़दम
yun	यूँ
yuun	यूँ
yoo	यूँ
yuhi	यूँ
vo	वो
wo	वो
who	वो
sooraj	सूरज
suraj	सूरज
suuraj	सूरज
nikla	निकला
nikalaa	निकला
nikala	निकला
niklaa	निकला
kuchh	कुछ
kuch	कुछ
kucch	कुछ
kuchi	कुछ
pighla	पिघला
pighala	पिघला
pigla	पिघला
aandhi	आँधी
andhi	आँधी
aayi	आयी
aai	आयी
aah	आह
ah	आह
nikli	निकली
nikali	निकली
nikalii	निकली
nikalee	निकली
aakhir	आखिर
mushkil	मुशकिल
mushakil	मुशकिल
mushakila	मुशकिल
piya	पिया
piyaa	पिया
pyaar	पिया
peeya	पिया
pedon	पेड़ों
pedo	पेड़ों
utrey	उतरे
utre	उतरे
uttrey	उतरे
utare	उतरे
phir	फिर
fir	फिर
fhir	फिर
dard	दर्द
darde	दर्द
darda	दर्द
hoga	होगा
hogaa	होगा
bandhan	बन्धन
rishton	रिश्तों
kaaton	काँटों
katoon	काँटों
kaanton	काँटों
kaanto	काँटों
kanton	काँटों
taarein	तारें
tarein	तारें
taaren	तारें
taare	तारें
patthar	पत्थर
pathar	पत्थर
pathhar	पत्थर
paththar	पत्थर
pather	पत्थर
belein	बेलें
bele	बेलें
belen	बेलें
ugti	उगती
khilte	खिलते
khilate	खिलते
chalte	चलते
chalate	चलते
afsaane	अफ़साने
afsane	अफ़साने
afasaane	अफ़साने
afsaanon	अफ़साने
afsaanse	अफ़साने
kirdaar	किरदार
milte	मिलते
milate	मिलते
miltey	मिलते
milthe	मिलते
miilate	मिलते
rishtey	रिश्ते
rishte	रिश्ते
chulbule	चुलबुले
bulbule	बुलबुले
bujhte	बुझते
bujhate	बुझते
buzate	बुझते
jiya	जिया
jiyaa	जिया
jeeya	जिया
jogiya	जिया
jia	जिया
do	दो
patte	पत्ते
patjhad	पतझड़
shakhon	शाखों
shaakhon	शाखों
mausam	मौसम
mosam	मौसम
mousam	मौसम
mausama	मौसम
mausum	मौसम
bechaare	बेचारे
bechare	बेचारे
ugne	उगने
ugane	उगने
chahat	चाहत
chaahat	चाहत
chaahata	चाहत
chaahati	चाहत
sahraon	सहरों
saharon	सहरों
bante	बनते
banate	बनते
rahte	रहते
rahate	रहते
rehte	रहते
rehtee	रहते
rahete	रहते
rehate	रहते
rehtey	रहते
rahetey	रहते
chalati	चलती
chalti	चलती
chalatii	चलती
chalathi	चलती
chalthi	चलती
chalte	चलती
jaaye	जाये
jaye	जाये
jayen	जाये
jaayen	जाये
jalaye	जाये
jhaaye	जाये
zindagi	ज़िंदगी
zindagii	ज़िंदगी
zindagee	ज़िंदगी
zindgai	ज़िंदगी
zinagi	ज़िंदगी
zinadgi	ज़िंदगी
zindigi	ज़िंदगी
zindgi	ज़िंदगी
dagar	डगर
safar	सफ़र
manzil	मन्ज़िल
use	उसे
usse	उसे
usey	उसे
usee	उसे
uuse	उसे
ussey	उसे
usike	उसे
rahi	राही
raahii	राही
raahi	राही
rahee	राही
raahee	राही
mud	मुड़
dekhe	देखे
dekde	देखे
dekke	देखे
deken	देखे
dekhen	देखे
dekhke	देखे
dekhee	देखे
bole	बोले
bhole	बोले
bhoole	बोले
boley	बोले
bholey	बोले
bhed	भेद
apane	अपने
apne	अपने
appne	अपने
aapne	अपने
apanee	अपने
apney	अपने
khole	खोले
aya	आया
aaya	आया
aayaa	आया
ayaa	आया
aaja	आया
aaaa	आया
kis	किस
kisi	किस
kiss	किस
kaise	किस
kisa	किस
kise	किस
kaisi	किस
desh	देश
des	देश
nirasha	निराशा
niraasha	निराशा
niraashaa	निराशा
chehara	चेहरा
cheharaa	चेहरा
chehraa	चेहरा
chehra	चेहरा
chehera	चेहरा
ki	कि
koyi	कि
koi	कि
kii	कि
kora	कोरा
safa	सफ़ा
khushiyaan	खुशियाँ
khushiya	खुशियाँ
khushiyan	खुशियाँ
jiske	जिसके
jisake	जिसके
jiski	जिसके
kyon	क्यों
kyun	क्यों
kyo	क्यों
kyoon	क्यों
kyoo	क्यों
kahon	क्यों
khushi	खुशी
kushi	खुशी
deewana	दीवाना
divaanaa	दीवाना
divaana	दीवाना
deewaana	दीवाना
deevaana	दीवाना
diwana	दीवाना
diivaanaa	दीवाना
diwaanaa	दीवाना
diivaana	दीवाना
deevaanaa	दीवाना
dewaana	दीवाना
deewaanaa	दीवाना
diwaana	दीवाना
deewwaana	दीवाना
dewanna	दीवाना
divana	दीवाना
mubarak	मुबारक
mubaarak	मुबारक
mauke	मौके
pesh	पेश
duaon	दुआओं
duaaon	दुआओं
duwaaon	दुआओं
duaawon	दुआओं
nazraana	नज़राना
nazaraanaa	नज़राना
nazaraana	नज़राना
nazarana	नज़राना
nazrana	नज़राना
nazraanaa	नज़राना
najarana	नज़राना
der	देर
dher	देर
samjha	समझा
samajhaa	समझा
samajha	समझा
samjhaa	समझा
samja	समझा
samaja	समझा
zamana	ज़माना
zamaanaa	ज़माना
zamaana	ज़माना
jamana	ज़माना
jamaana	ज़माना
zamaane	ज़माना
shukar	शुक्र
shukr	शुक्र
shukra	शुक्र
shukrr	शुक्र
karo	करो
samajh	समझ
samaj	समझ
samje	समझ
samjh	समझ
khwaab	ख़्वाब
kvaab	ख़्वाब
khawaab	ख़्वाब
khvaab	ख़्वाब
khawab	ख़्वाब
khwab	ख़्वाब
kwaab	ख़्वाब
ban	बन
bin	बन
bun	बन
saj	सज
saja	सज
kaho	कहो
khud	कहो
kahoo	कहो
sari	सारी
saari	सारी
saarii	सारी
saaree	सारी
shaadi	सारी
saree	सारी
saare	सारी
saara	सारी
sarhi	सारी
mehfil	महफ़िल
mahafil	महफ़िल
mahfil	महफ़िल
mehefil	महफ़िल
mehafil	महफ़िल
keh	कह
kah	कह
kahe	कह
kaha	कह
kho	कह
afsaana	अफ़साना
afasaanaa	अफ़साना
afasaana	अफ़साना
afsaanaa	अफ़साना
afasana	अफ़साना
afsana	अफ़साना
liye	लिये
kaliyaan	कलियाँ
kaliyaa	कलियाँ
kaliya	कलियाँ
kaliyan	कलियाँ
bula	भुला
bhulaa	भुला
bhula	भुला
rahane	रहने
rehne	रहने
rahene	रहने
rehane	रहने
rahne	रहने
rehene	रहने
haqikat	हक़ीकत
hakikat	हक़ीकत
haqeekat	हक़ीकत
pal	पल
pala	पल
khel	खेल
rachaaye	रचाये
manzil	मंज़िल
chhod	छोड़
chod	छोड़
chhodh	छोड़
chodo	छोड़
chhoda	छोड़
aaye	आये
aye	आये
aake	आये
aae	आये
aayee	आये
aaja	आये
ayee	आये
aaj	आये
aave	आये
aai	आये
aayi	आये
aate	आये
mahakaa	महका
mehka	महका
maheka	महका
mehaka	महका
mahaka	महका
mehkaa	महका
mahkaa	महका
meheka	महका
mehakaa	महका
mahekaa	महका
aabaad	आबाद
abaad	आबाद
aabad	आबाद
viraanaa	वीराना
viraana	वीराना
veeraana	वीराना
veeraanaa	वीराना
veerana	वीराना
wiraanaa	वीराना
virana	वीराना
viiraanaa	वीराना
hans	हँस
hns	हँस
hamari	हमरी
hamarii	हमरी
hamri	हमरी
humri	हमरी
bhuul	भूल
bhul	भूल
bhula	भूल
denaa	देना
dienaa	देना
dena	देना
deeena	देना
tumhare	तुम्हरे
tumare	तुम्हरे
bulaa	बुला
bula	बुला
bhula	बुला
lenaa	लेना
lena	लेना
lenga	लेना
apanon	अपनों
apnon	अपनों
apno	अपनों
apano	अपनों
kaam	काम
kam	काम
begaanon	बेगानों
mol	मोल
karegi	करेगी
karegii	करेगी
karegee	करेगी
mufalis	मुफ़लिस
aramaanon	अरमानों
armaano	अरमानों
aramanon	अरमानों
armaanon	अरमानों
aarmaanon	अरमानों
armano	अरमानों
armaanoki	अरमानों
armanon	अरमानों
itani	इतनी
itni	इतनी
ithni	इतनी
itanii	इतनी
itanai	इतनी
bas	बस
bus	बस
baas	बस
basa	बस
apani	अपनी
apni	अपनी
apanii	अपनी
apnii	अपनी
apane	अपनी
apne	अपनी
appni	अपनी
aapni	अपनी
tamannaa	तमन्ना
tamanna	तमन्ना
paravaanaa	परवाना
parwaana	परवाना
paravaana	परवाना
parvaana	परवाना
parvaanaa	परवाना
parawaana	परवाना
parwana	परवाना
parawaanaa	परवाना
paravana	परवाना
parvana	परवाना
satrangi	सतरंगी
satarangii	सतरंगी
satrangii	सतरंगी
satarangi	सतरंगी
saaya	साया
saayaa	साया
saya	साया
saiya	साया
humsaaya	हमसाया
hamsaaya	हमसाया
hamasaaya	हमसाया
hamasaya	हमसाया
noor	नूर
nuur	नूर
nur	नूर
parchhai	परछाई
parchhaai	परछाई
parchhaaii	परछाई
parachhaai	परछाई
parchhaayi	परछाई
parchai	परछाई
parchhayi	परछाई
parchayi	परछाई
baar	बार
bar	बार
baat	बार
bada	बार
baad	बार
barr	बार
bata	बता
bataa	बता
btaa	बता
zor	ज़ोर
ghalib	ग़ालिब
gaalib	ग़ालिब
lagaye	लगाये
lagaaye	लगाये
bujhaye	बुझाये
bujhaaye	बुझाये
buzaaye	बुझाये
chhua	छुआ
chua	छुआ
chhuaa	छुआ
chuaa	छुआ
halka	हल्का
halkaa	हल्का
halakaa	हल्का
uns	उन्स
hua	हुआ
huaa	हुआ
huwa	हुआ
huva	हुआ
huya	हुआ
mehsoos	महसूस
mehsus	महसूस
mahasuus	महसूस
mahasoos	महसूस
mahasus	महसूस
mahsoos	महसूस
mahsus	महसूस
jeene	जीने
jiine	जीने
jine	जीने
jeeney	जीने
aarzoo	आरज़ू
aarzuu	आरज़ू
arazu	आरज़ू
aarzu	आरज़ू
aarazu	आरज़ू
aarazuu	आरज़ू
arzoo	आरज़ू
aarzo	आरज़ू
aanch	आँच
aach	आँच
saans	साँस
saas	साँस
saaans	साँस
saanson	साँस
sulagne	सुलगने
sulagane	सुलगने
lagte	लगते
lagate	लगते
dilaase	दिलासे
deta	देता
detaa	देता
uljha	उलझा
ulajha	उलझा
uljaa	उलझा
ulazaa	उलझा
ulajhaa	उलझा
munhzor	मंज़ूर
manzoor	मंज़ूर
manzur	मंज़ूर
manzuur	मंज़ूर
sargoshi	सरगोशी
saragoshi	सरगोशी
ghulii	घुली
ghuli	घुली
karta	करता
karata	करता
karataa	करता
kartaa	करता
kerta	करता
kartha	करता
behoshii	बेहोशी
behoshi	बेहोशी
behoshee	बेहोशी
raahon	राहों
raho	राहों
rahon	राहों
raaho	राहों
rahoon	राहों
baahon	बाहों
baaho	बाहों
baaahoin	बाहों
baahen	बाहों
baho	बाहों
bahon	बाहों
baaton	बाहों
baahoin	बाहों
baanhon	बाहों
bahoon	बाहों
baagon	बाहों
banhon	बाहों
bahaon	बाहों
chaahon	चाहों
jiina	जीना
jinaa	जीना
jeenaa	जीना
jeena	जीना
jina	जीना
jiinaa	जीना
junuun	जुनूँ
junun	जुनूँ
junoon	जुनूँ
marna	मरना
marrna	मरना
marana	मरना
maranaa	मरना
marnaa	मरना
maut	मौत
mout	मौत
god	गोद
godi	गोद
godh	गोद
ruuh	रूह
ruh	रूह
ruhu	रूह
dubone	डुबोने
bijali	बिजली
bijli	बिजली
bijalee	बिजली
bijlee	बिजली
bijalii	बिजली
bijlii	बिजली
aap	आप
app	आप
ap	आप
mar	मर
mara	मर
marr	मर
meri	मर
mere	मर
mera	मर
moro	मर
jaante	जानते
jaanate	जानते
jante	जानते
kahenge	कहेंगे
chaahenge	कहेंगे
albele	अलबेले
alabele	अलबेले
yeh	यह
yah	यह
yaha	यह
humsafar	हमसफ़र
hamasafar	हमसफ़र
humasafar	हमसफ़र
hamsafar	हमसफ़र
chal	चल
chale	चल
chalo	चल
denge	देंगे
dhenge	देंगे
deingey	देंगे
le	ले
lle	ले
len	ले
jaayega	जाएगा
jaaega	जाएगा
jaayegaa	जाएगा
jayega	जाएगा
jaaegaa	जाएगा
jaanyega	जाएगा
jaaegya	जाएगा
jayeega	जाएगा
jidhar	जिधर
kho	खो
ko	खो
jaayenge	जाएँगे
jayenge	जाएँगे
jaaenge	जाएँगे
jaayege	जाएँगे
jaayeinge	जाएँगे
asar	असर
asara	असर
aasar	असर
lagata	लगता
lagta	लगता
lagataa	लगता
lagtaa	लगता
lagthaa	लगता
gaye	गये
gayee	गये
gayi	गये
toota	टूटा
tuuta	टूटा
tuutaa	टूटा
tuta	टूटा
tutaa	टूटा
thota	टूटा
teer	तीर
tiir	तीर
tir	तीर
tiira	तीर
rahakar	रहकर
rehkar	रहकर
rehakar	रहकर
rahkar	रहकर
tasvir	तस्वीर
tasveer	तस्वीर
tasviir	तस्वीर
tasaweer	तस्वीर
nind	नींद
niind	नींद
neele	नींद
needh	नींद
aati	आती
ati	आती
ahti	आती
aaraam	आराम
araam	आराम
aaram	आराम
baaten	बातें
baatein	बातें
baate	बातें
baithen	बातें
batein	बातें
kisse	किस्से
haradam	हरदम
hardam	हरदम
hardum	हरदम
darate	डरते
darte	डरते
darrte	डरते
anjaam	अंजाम
nazar	नज़र
nazer	नज़र
chale	चले
chalen	चले
chaale	चले
chalye	चले
varna	वरना
warna	वरना
varana	वरना
varanaa	वरना
varnaa	वरना
warana	वरना
waranaa	वरना
ghaayal	घायल
ghayal	घायल
gayal	घायल
kar	कर
kara	कर
karo	कर
karr	कर
kare	कर
ker	कर
jaata	जाता
jaataa	जाता
jata	जाता
jaathaa	जाता
jataa	जाता
jaatha	जाता
jaate	जाता
agni	अग्नि
dekhte	देखते
dekhate	देखते
dektey	देखते
kam	कम
kum	कम
dete	देते
beqaabu	बेक़ाबू
beqaaboo	बेक़ाबू
bekaabu	बेक़ाबू
beqaabuu	बेक़ाबू
saamne	सामने
samne	सामने
saamane	सामने
samane	सामने
sammne	सामने
jaate	जाते
jaatey	जाते
jate	जाते
haseen	हसीन
hasin	हसीन
hasiin	हसीन
jawaan	जवान
javaan	जवान
jawaani	जवान
jawan	जवान
javaana	जवान
saare	सारे
sarhey	सारे
saaare	सारे
sare	सारे
saaree	सारे
sahaare	सारे
khul	खुल
kab	कब
kaba	कब
kabh	कब
chhupenge	छुपेंगे
shaan	शान
shan	शान
ek	एक
eka	एक
roz	रोज़
arre	अरे
arey	अरे
are	अरे
arree	अरे
aare	अरे
maine	मैंने
mainne	मैंने
meine	मैंने
mainn	मैंने
banta	बनता
banata	बनता
banataa	बनता
bunataa	बनता
haath	हाथ
hath	हाथ
lo	लो
llo	लो
tak	तक
taka	तक
taki	तक
hoti	होती
hotii	होती
hotee	होती
hothi	होती
hote	होती
rahe	रहे
rehe	रहे
rahee	रहे
baithe	बैठे
baite	बैठे
kahein	कहें
kahen	कहें
aag	आग
agg	आग
ag	आग
lag	लग
laga	लग
lage	लग
liya	लिया
liyaa	लिया
waqt	वक़्त
vaqt	वक़्त
aage	आगे
aaghe	आगे
age	आगे
nikal	निकल
aapako	आपको
appko	आपको
aapko	आपको
apako	आपको
dekhataa	देखता
dekhata	देखता
dekhta	देखता
dekhthaa	देखता
jise	जिसे
jisse	जिसे
jisey	जिसे
jisake	जिसे
jiske	जिसे
mil	मिल
mile	मिल
mila	मिल
jaayen	जाएं
jaaen	जाएं
jayen	जाएं
jaaein	जाएं
usaki	उसकी
uski	उसकी
usakii	उसकी
uskii	उसकी
usakee	उसकी
uske	उसकी
usiki	उसकी
zindagi	ज़िन्दगी
zindagii	ज़िन्दगी
zindage	ज़िन्दगी
zinadagi	ज़िन्दगी
zindagee	ज़िन्दगी
taarifen	तारीफ़ें
tarifein	तारीफ़ें
taarifein	तारीफ़ें
tareefein	तारीफ़ें
karake	करके
karke	करके
badanaam	बदनाम
badnaam	बदनाम
badanaama	बदनाम
badnam	बदनाम
badanam	बदनाम
aapakaa	आपका
aapka	आपका
aapaka	आपका
aapkaa	आपका
apaka	आपका
javaab	जवाब
jawab	जवाब
jawaab	जवाब
salaam	सलाम
salaame	सलाम
salaama	सलाम
salam	सलाम
chaahuun	चाहूँ
chaahun	चाहूँ
chaahoon	चाहूँ
chahoon	चाहूँ
chadhoon	चाहूँ
chaahon	चाहूँ
likh	लिख
sochane	सोचने
sochney	सोचने
sochne	सोचने
maukaa	मौका
mauka	मौका
muka	मौका
jaan	जान
jaane	जान
jaana	जान
jana	जान
jahaan	जान
jan	जान
jane	जान
jawaan	जान
jaa	जान
jaun	जान
jubaan	जान
jaano	जान
jaam	जान
jaanu	जान
jaal	जान
jawan	जान
jaao	जान
jahan	जान
jaanaan	जानां
jaanaa	जानां
janaa	जानां
jaldi	जळी
juldi	जळी
itanaa	इतना
itana	इतना
itna	इतना
itnaa	इतना
itne	इतना
mat	मत
mata	मत
matt	मत
badh	बढ़
bad	बढ़
jaanaa	जाना
jaana	जाना
jana	जाना
jaanta	जाना
janaa	जाना
jalaana	जाना
jalaa	जाना
janam	जाना
jaanam	जाना
zaraa	जाना
bade	बड़े
badhe	बड़े
kuubasuurat	ख़ूबसूरत
koobasuurat	ख़ूबसूरत
kubasurat	ख़ूबसूरत
khubsoorat	ख़ूबसूरत
khubsurat	ख़ूबसूरत
chaahe	चाहे
chahe	चाहे
chahey	चाहे
chhahe	चाहे
kaise	कैसे
kise	कैसे
dilabar	दिलबर
dilbar	दिलबर
dilabara	दिलबर
dilbhar	दिलबर
dilbaar	दिलबर
dengi	देंगी
dengee	देंगी
denge	देंगी
degi	देंगी
batalaa	बतला
batla	बतला
batala	बतला
dije	दीजे
deeje	दीजे
soch	सोच
sochte	सोच
sochke	सोच
sochlo	सोच
bataaenge	बताएंगे
bataayenge	बताएंगे
rahaa	रहा
raha	रहा
rahan	रहा
kije	कीजे
kiije	कीजे
mile	मिले
miley	मिले
milte	मिले
mili	मिले
milen	मिले
puuchho	पूछो
pucho	पूछो
puchho	पूछो
poochho	पूछो
poocho	पूछो
puchh	पूछो
pooch	पूछो
puchcho	पूछो
poochhe	पूछो
palak	पलक
band	बन्द
bandh	बन्द
bataauun	बताऊँ
bataun	बताऊँ
bataayuun	बताऊँ
bataaoon	बताऊँ
bataon	बताऊँ
bathaaun	बताऊँ
bataaun	बताऊँ
bataaoo	बताऊँ
bataoo	बताऊँ
bataoon	बताऊँ
battaun	बताऊँ
saathiyaa	साथिया
saathiya	साथिया
saathiyan	साथिया
sathiya	साथिया
saathiyaan	साथिया
dhintaanaa	धिन्ताना
luun	लूँ
loon	लूँ
lun	लूँ
loo	लूँ
itane	इतने
itne	इतने
karib	करीब
kariib	करीब
kareeb	करीब
qarib	करीब
nazadik	नज़दीक
nazdeek	नज़दीक
nazadeek	नज़दीक
najadik	नज़दीक
nazadiik	नज़दीक
nazdik	नज़दीक
dekh	देख
dek	देख
tadapataa	तड़पता
tadapta	तड़पता
tadapata	तड़पता
tadaptaa	तड़पता
karavat	करवट
karvat	करवट
karawat	करवट
karwat	करवट
badal	बदल
badul	बदल
bdal	बदल
kasam	कसम
qasam	कसम
jaagi	जागी
jaagii	जागी
jaagee	जागी
jaage	जागी
nazaron	नज़रों
najaron	नज़रों
nazron	नज़रों
nazaro	नज़रों
nazaroon	नज़रों
nazro	नज़रों
raho	रहो
rahoo	रहो
gar	गर
umr	उम्र
umra	उम्र
umrr	उम्र
umar	उम्र
umre	उम्र
bahakataa	बहकता
bahakata	बहकता
bahakta	बहकता
bahekta	बहकता
behekta	बहकता
behakta	बहकता
honahaar	होनहार
honhaar	होनहार
pyaare	प्यारे
pyare	प्यारे
pyaere	प्यारे
bachche	बच्चे
bacche	बच्चे
umar	उमर
umr	उमर
umra	उमर
kachche	कच्चे
kacche	कच्चे
sachche	सच्चे
sacche	सच्चे
saccche	सच्चे
butaauun	बुताऊँ
musibaton	मुसीबतों
museebaton	मुसीबतों
daro	डरो
darro	डरो
buzadil	बुज़दिल
maro	मरो
rote	रोते
roote	रोते
naacho	नाचो
nacho	नाचो
naachon	नाचो
dukh	दुख
taan	तान
taang	तान
sinaa	सीना
seena	सीना
seenaa	सीना
siinaa	सीना
sina	सीना
dhum	धुम
andhiyaari	अंधियारी
andhiyari	अंधियारी
ghataayen	घटायें
ghataayein	घटायें
ghatayen	घटायें
kaari	कारी
kaali	कारी
hon	हों
ho	हों
hoon	हों
hoo	हों
raastaa	रास्ता
raasta	रास्ता
rasta	रास्ता
raasataa	रास्ता
rastaa	रास्ता
sunasaan	सुनसान
sunsaan	सुनसान
sunsan	सुनसान
tuufaan	तूफ़ान
toofaan	तूफ़ान
tufaan	तूफ़ान
toofan	तूफ़ान
tofaan	तूफ़ान
toofaann	तूफ़ान
paanv	पाँव
paao	पाँव
paon	पाँव
paaon	पाँव
paanw	पाँव
paau	पाँव
paav	पाँव
paani	पाँव
paaw	पाँव
panv	पाँव
majabuur	मजबूर
majabur	मजबूर
majaboor	मजबूर
majboor	मजबूर
majbur	मजबूर
majhboor	मजबूर
karoge	करोगे
ruk	रुक
rukk	रुक
rukja	रुक
rukh	रुक
ruke	रुक
ruka	रुक
jaaoge	जाओगे
jaayoge	जाओगे
jaoge	जाओगे
jaaogey	जाओगे
insaanon	इन्सानों
duhkh	दुःख
halkaan	हल्कान
apanaa	अपना
apnaa	अपना
apna	अपना
apana	अपना
appna	अपना
apnana	अपना
aapna	अपना
sab	सब
sub	सब
sabh	सब
saba	सब
qurabaan	क़ुरबान
qurbaan	क़ुरबान
bebas	बेबस
bebass	बेबस
bebus	बेबस
ujad	उजड़
ujaad	उजड़
ujada	उजड़
huye	हुये
agar	अगर
aagar	अगर
aggar	अगर
barabaad	बरबाद
barbaad	बरबाद
barbad	बरबाद
barabad	बरबाद
barabaada	बरबाद
rooge	रोओगे
roooge	रोओगे
rowoge	रोओगे
jag	जग
jug	जग
jaga	जग
ladaai	लड़ाई
ladaayi	लड़ाई
ladaaii	लड़ाई
vatan	वतन
watan	वतन
ghuse	घुसे
lutere	लुटेरे
aazaadi	आज़ादी
azaaadi	आज़ादी
azadi	आज़ादी
azaadi	आज़ादी
aazadi	आज़ादी
ghere	घेरे
banduukon	बन्दूकों
laachaar	लाचार
sarataaj	सरताज
sartaaj	सरताज
mukh	मुख
mod	मोड़
modh	मोड़
mood	मोड़
modke	मोड़
tod	तोड़
thodi	तोड़
todh	तोड़
thod	तोड़
todke	तोड़
todd	तोड़
todee	तोड़
toda	तोड़
dhokhebaaj	धोखेबाज
diyaa	दिया
daiyyaa	दिया
diya	दिया
dia	दिया
duniyaa	दिया
tikhaa	तीखा
tikha	तीखा
tiikhaa	तीखा
waala	वाला
vaala	वाला
wala	वाला
vaalaa	वाला
vala	वाला
waalaa	वाला
waalah	वाला
bhala	वाला
wohi	वही
vahi	वही
wahi	वही
vohi	वही
wahee	वही
vahii	वही
vahee	वही
haar	हार
har	हार
haare	हार
maan	मान
man	मान
mann	मान
main	मान
maaf	मान
matwaale	मतवाले
matawaale	मतवाले
matavaale	मतवाले
matwale	मतवाले
matvaale	मतवाले
matavale	मतवाले
badhta	बढ़ता
badta	बढ़ता
badhata	बढ़ता
badhataa	बढ़ता
badhtaa	बढ़ता
sukh	सुख
bisraa	बिसरा
bisara	बिसरा
bisra	बिसरा
jale	जले
jaale	जले
rahaguzar	रहगुज़र
rehguzar	रहगुज़र
rehaguzar	रहगुज़र
manzilen	मन्ज़िलें
manzile	मन्ज़िलें
milen	मिलें
milein	मिलें
mile	मिलें
miley	मिलें
dam	दम
dum	दम
marhale	मर्हले
ant	अंत
anta	अंत
jisaka	जिसका
jiska	जिसका
jisakaa	जिसका
jiskaa	जिसका
jisska	जिसका
jisaki	जिसकी
jiski	जिसकी
jisakee	जिसकी
jisakii	जिसकी
jisski	जिसकी
disha	दिशा
dishaa	दिशा
sangi	संगी
andhiyaare	अंधियारे
ujiyaare	उजियारे
dikhaayen	दिखायें
dikhaayein	दिखायें
dikhaye	दिखायें
phulajhaare	फुलझारे
pathik	पथिक
taare	तारे
thaare	तारे
taaren	तारे
tare	तारे
tarhey	तारे
tara	तारे
tere	तारे
kitane	कितने
kitne	कितने
kitney	कितने
mele	मेले
milke	मेले
chune	चुने
khushiyon	खुशियों
khushiyo	खुशियों
khushiyoon	खुशियों
kaaton	काटों
khele	खेले
kehle	खेले
chalana	चलना
chalanaa	चलना
chalna	चलना
chalnaa	चलना
hote	होते
hoten	होते
hotey	होते
humara	हमारा
hamaara	हमारा
hamara	हमारा
humaaraa	हमारा
hamaaraa	हमारा
humaraa	हमारा
humaara	हमारा
hota	होता
hotaa	होता
hoyta	होता
bablu	बबलू
kehti	कहती
kahati	कहती
kahatee	कहती
kehte	कहती
kahatii	कहती
kaheti	कहती
kehati	कहती
kehethi	कहती
kahti	कहती
keheti	कहती
kehatee	कहती
laata	लाता
gudiya	गुड़िया
gudiyaa	गुड़िया
gudeeyaa	गुड़िया
gudiyaan	गुड़िया
gudeeyaan	गुड़िया
motor	मोटर
motar	मोटर
pyari	प्यारी
pyaaree	प्यारी
pyaari	प्यारी
pyaarii	प्यारी
pyaree	प्यारी
pyare	प्यारी
pyar	प्यारी
pyaar	प्यारी
pyaare	प्यारी
bholi	भोली
bholii	भोली
boli	भोली
bhole	भोली
chinta	चिन्ता
chintaa	चिन्ता
roti	रोटी
rotii	रोटी
fikar	फिकर
phikar	फिकर
munne	मुन्ने
piche	पीछे
peechhe	पीछे
peeche	पीछे
pichhe	पीछे
piichhe	पीछे
peche	पीछे
peechee	पीछे
banke	बनके
banake	बनके
naukar	नौकर
khate	खाते
khaate	खाते
pite	पीते
peete	पीते
pitey	पीते
piite	पीते
duddu	दुद्दू
haste	हँसते
hansate	हँसते
hasate	हँसते
hanste	हँसते
hasthe	हँसते
naak	नाक
lukka	लुक्क
chuppi	छुपी
chhupi	छुपी
chupi	छुपी
chuphi	छुपी
chupii	छुपी
chhupii	छुपी
danga	दंगा
zid	ज़िद
zidd	ज़िद
adiyal	अड़ियल
haal	हाल
hal	हाल
haale	हाल
haala	हाल
beeta	बीता
beetaa	बीता
bita	बीता
biitaa	बीता
bitaa	बीता
bachpan	बचपन
bachapan	बचपन
bachchpan	बचपन
biwi	बीवी
bivi	बीवी
biivii	बीवी
beevi	बीवी
anban	अनबन
anaban	अनबन
bail	बैल
sar	सर
sare	सर
sarr	सर
sir	सर
sara	सर
sarf	सर
appke	आपके
aapake	आपके
aapke	आपके
apke	आपके
pher	फेर
rukiye	रुकिए
suniye	सुनिए
wohin	वहीं
vahin	वहीं
wahee	वहीं
wahin	वहीं
vaheen	वहीं
wahii	वहीं
vahiin	वहीं
tarah	तरह
tarha	तरह
taraha	तरह
tarahu	तरह
tauhin	तौहीन
appki	आपकी
aapki	आपकी
aapaki	आपकी
aapakii	आपकी
nigaahon	निगाहों
nigahoon	निगाहों
nigaho	निगाहों
nigaaho	निगाहों
nigahon	निगाहों
nighahon	निगाहों
nighaahon	निगाहों
nigahoo	निगाहों
bharosa	भरोसा
bharosaa	भरोसा
churata	चुराता
churaata	चुराता
churaataa	चुराता
kaun	कौन
koun	कौन
churaya	चुराया
churaaya	चुराया
churaayaa	चुराया
chuaraya	चुराया
pehlu	पहलू
pahalu	पहलू
pahloo	पहलू
pahelu	पहलू
pehalu	पहलू
pahaluu	पहलू
pahaloo	पहलू
pehloo	पहलू
chupaye	छुपाए
chhipaaye	छुपाए
chhupaae	छुपाए
chhupaaye	छुपाए
chuppaye	छुपाए
chupaaye	छुपाए
lekin	लेकिन
lekien	लेकिन
lekeen	लेकिन
dila	दिला
dilaa	दिला
deejiye	दीजिए
dijie	दीजिए
dijiye	दीजिए
deejie	दीजिए
diijie	दीजिए
sapno	सपनों
sapanon	सपनों
sapnon	सपनों
sapnoin	सपनों
sapano	सपनों
sapnoon	सपनों
sapnoo	सपनों
bithaye	बिठाये
bithaaye	बिठाये
bitaaye	बिठाये
rakhna	रखना
rakhana	रखना
rakna	रखना
sajna	सजना
sajanaa	सजना
sajana	सजना
sajanaaa	सजना
sajnaa	सजना
tumne	तुमने
tumane	तुमने
tumnee	तुमने
tunne	तुमने
baj	बज
uthe	उठे
uhtey	उठे
uthhe	उठे
jaisa	जैसा
jaisaa	जैसा
waise	वैसे
vaise	वैसे
shuru	शुरू
shuruu	शुरू
kahani	कहानी
kahaani	कहानी
kahaanee	कहानी
kahaanii	कहानी
kahaane	कहानी
duja	दूजा
dujaa	दूजा
duuja	दूजा
duujaa	दूजा
dooja	दूजा
dujha	दूजा
doojaan	दूजा
gaon	गाँव
gaanv	गाँव
gaav	गाँव
gaaon	गाँव
gaanw	गाँव
gaaoo	गाँव
gaau	गाँव
chota	छोटा
chhota	छोटा
chhotaa	छोटा
chohta	छोटा
choota	छोटा
sa	सा
saa	सा
sam	सा
sham	सा
saal	सा
sab	सा
sau	सा
sar	सा
kisi	किसी
kisee	किसी
kaise	किसी
kisii	किसी
kissi	किसी
kiske	किसी
kisie	किसी
kisse	किसी
kaisee	किसी
kise	किसी
kaisi	किसी
iske	इसके
isake	इसके
siva	सिवा
sivaa	सिवा
siwa	सिवा
siwaa	सिवा
siwan	सिवा
duji	दूजी
dooji	दूजी
duuji	दूजी
doojee	दूजी
chah	चाह
chaah	चाह
chaaha	चाह
chaha	चाह
tumhin	तुम्हीं
tumheen	तुम्हीं
tumhiin	तुम्हीं
tumhein	तुम्हीं
puravaiyaa	पुरवैया
purvaiya	पुरवैया
purawaiya	पुरवैया
puravaiya	पुरवैया
jhonke	झोंके
jhoke	झोंके
chandan	चन्दन
mahak	महक
mahek	महक
mehak	महक
mahaka	महक
mehek	महक
laaye	लाये
laye	लाये
laai	लाये
laayi	लाये
nindyaa	निन्द्या
muskaaye	मुस्काये
musakaye	मुस्काये
muskaye	मुस्काये
muund	मूँद
mood	मूँद
moond	मूँद
nainon	नैनों
dulhan	दुल्हन
bujhaa	बुझा
bujha	बुझा
buzaa	बुझा
booja	बुझा
bhuja	बुझा
buja	बुझा
bujaa	बुझा
jaage	जागे
jaagey	जागे
jage	जागे
usako	उसको
usko	उसको
ussko	उसको
soye	सोये
sulaaye	सुलाये
ja	जा
jaa	जा
jab	जा
jag	जा
jaao	जा
jara	जा
jaan	जा
jiya	जा
jaau	जा
jana	जा
jaha	जा
jaai	जा
jaag	जा
jaae	जा
zaa	जा
ri	री
re	री
rii	री
shor	शोर
sor	शोर
macha	मचा
machaa	मचा
nindiya	निंदिया
nindiyaa	निंदिया
nindiyaan	निंदिया
kinaare	किनारे
kinare	किनारे
nadiya	नदिया
nadiyaa	नदिया
nadiyan	नदिया
nadiyaan	नदिया
so	सो
soo	सो
godi	गोदी
sajni	सजनी
sajani	सजनी
sajanii	सजनी
aansoo	आँसू
aansu	आँसू
aansuu	आँसू
aanso	आँसू
aasoo	आँसू
ansu	आँसू
aasu	आँसू
ansoo	आँसू
jaanam	जानम
janam	जानम
janum	जानम
tujh	तुझ
tuz	तुझ
tujhe	तुझ
bin	बिन
bina	बिन
bina	बिना
binaa	बिना
beshumaar	बेशुमार
sandhya	संध्या
sandhyaa	संध्या
baadalon	बादलों
baadlon	बादलों
badaalo	बादलों
badalo	बादलों
badalon	बादलों
baadalo	बादलों
poonam	पूनम
puunam	पूनम
punam	पूनम
chanda	चंदा
chandaa	चंदा
chanhda	चंदा
hogi	होगी
hogii	होगी
hoongi	होगी
hogee	होगी
hongi	होगी
maanta	मानता
maanata	मानता
maanataa	मानता
manta	मानता
jaana	जानाँ
jaanaan	जानाँ
jaanaa	जानाँ
jana	जानाँ
kal	कल
kala	कल
kate	कटे
mushkil	मुश्किल
muskil	मुश्किल
mushakil	मुश्किल
mushkila	मुश्किल
muskhil	मुश्किल
poochh	पूछ
puuchh	पूछ
pooch	पूछ
puchh	पूछ
puch	पूछ
puuch	पूछ
maane	माने
mane	माने
saal	साल
sal	साल
jaan	जाँ
jan	जाँ
jaa	जाँ
jaat	जाँ
rastaa	रस्ता
rasta	रस्ता
jaltaa	जलता
jalta	जलता
jalata	जलता
jalataa	जलता
khilti	खिलती
khilati	खिलती
khilatii	खिलती
jaaye	जायें
jaayen	जायें
jaayein	जायें
jayein	जायें
jaye	जायें
jayen	जायें
barkhaa	बरखा
barkha	बरखा
barakha	बरखा
barakhaa	बरखा
bheege	भीगे
bhige	भीगे
bege	भीगे
bhiige	भीगे
aasmaan	आसमाँ
aasamaan	आसमाँ
asaman	आसमाँ
asmaan	आसमाँ
aasaman	आसमाँ
aasamaa	आसमाँ
aasman	आसमाँ
aasmaa	आसमाँ
udtaa	उड़ता
udta	उड़ता
udata	उड़ता
udataa	उड़ता
urdta	उड़ता
chandramaa	चंद्रमा
chandrama	चंद्रमा
kahne	कहने
kahane	कहने
kehne	कहने
kahene	कहने
kehane	कहने
kehene	कहने
marti	मरती
marati	मरती
martii	मरती
jalti	जलती
jalati	जलती
jalatii	जलती
jalatee	जलती
jalthi	जलती
agni	अग्नी
uthtaa	उठता
uthata	उठता
uttha	उठता
uthataa	उठता
uthta	उठता
bujhti	बुझती
bujhatii	बुझती
bujhati	बुझती
seene	सीने
sine	सीने
siine	सीने
seeney	सीने
maine	मैने
mene	मैने
mane	मैने
meine	मैने
baaki	बाकी
baakii	बाकी
baakee	बाकी
baaqi	बाकी
bakii	बाकी
bakki	बाकी
baki	बाकी
dilrubaa	दिलरुबा
dilaruba	दिलरुबा
dilruba	दिलरुबा
dilarubaa	दिलरुबा
dilrooba	दिलरुबा
tumse	तुमसे
tumase	तुमसे
baanhon	बाँहों
baahon	बाँहों
banho	बाँहों
baanhen	बाँहों
baaho	बाँहों
bahon	बाँहों
roshani	रोशनी
roshni	रोशनी
roshini	रोशनी
muskura	मुस्कुरा
muskuraa	मुस्कुरा
muskuraake	मुस्कुरा
muskurake	मुस्कुरा
muskuraado	मुस्कुरा
pyaasi	प्यासी
pyaasii	प्यासी
pyaasee	प्यासी
pyasi	प्यासी
mamata	ममता
mamataa	ममता
mamta	ममता
mamtaa	ममता
tarase	तरसे
tarse	तरसे
aangan	आँगन
angna	आँगन
suunaa	सूना
suuna	सूना
sunaa	सूना
suna	सूना
soona	सूना
bhaali	भाली
bhali	भाली
bhaalii	भाली
in	इन
inn	इन
ina	इन
matavaali	मतवाली
matawaalee	मतवाली
matwaali	मतवाली
matvaali	मतवाली
mathvali	मतवाली
matavaalii	मतवाली
matwali	मतवाली
matawaali	मतवाली
manahar	मनहर
sapana	सपना
sapanaa	सपना
sapnaa	सपना
sapna	सपना
yaad	याद
yaada	याद
yad	याद
yaaad	याद
yaadon	याद
yehad	याद
mohabbat	मोहब्बत
mohobbat	मोहब्बत
mohabbata	मोहब्बत
mohbbat	मोहब्बत
zameen	ज़मीं
zamee	ज़मीं
zamiin	ज़मीं
zamin	ज़मीं
zamii	ज़मीं
aasamaan	आसमां
aasmaan	आसमां
aasman	आसमां
asmaan	आसमां
asaman	आसमां
faasla	फ़ासला
faasalaa	फ़ासला
faasala	फ़ासला
faaslaa	फ़ासला
faslaa	फ़ासला
darmiyaan	दर्मियां
daramiyaan	दर्मियां
rangon	रंगों
rango	रंगों
khushbu	खुश्बू
khushboo	खुश्बू
khushbuu	खुश्बू
khusbu	खुश्बू
angadaai	अंगड़ाई
angdaai	अंगड़ाई
angadaaii	अंगड़ाई
angadaayi	अंगड़ाई
angdai	अंगड़ाई
angdayi	अंगड़ाई
angadai	अंगड़ाई
angdaayi	अंगड़ाई
angdhaayi	अंगड़ाई
aangdayi	अंगड़ाई
dooje	दूजे
duje	दूजे
duuje	दूजे
dujhe	दूजे
dujeke	दूजे
tanhaai	तन्हाई
tanhaayi	तन्हाई
tanhai	तन्हाई
tanhayi	तन्हाई
jagah	जगह
jagaha	जगह
jageh	जगह
jagaah	जगह
fiza	फ़िज़ा
fizaa	फ़िज़ा
bhulaana	भुलाना
bhulaanaa	भुलाना
bhulana	भुलाना
chaahaton	चाहतों
chaahton	चाहतों
chahton	चाहतों
chahaton	चाहतों
chaahato	चाहतों
chahato	चाहतों
roshan	रोशन
panaahon	पनाहों
panaaho	पनाहों
panaho	पनाहों
sadiyon	सदियों
sadiyo	सदियों
saadiyon	सदियों
sadhiyon	सदियों
dua	दुआ
duaa	दुआ
badale	बदले
badle	बदले
badley	बदले
mahaboob	महबूब
mehboob	महबूब
mahabuub	महबूब
mehaboob	महबूब
mahabub	महबूब
mehbooob	महबूब
mehbub	महबूब
haseen	हसीं
hasin	हसीं
hasiin	हसीं
hasee	हसीं
milata	मिलता
milta	मिलता
milataa	मिलता
miltaa	मिलता
zulfon	ज़ुल्फ़ों
zulfo	ज़ुल्फ़ों
julfon	ज़ुल्फ़ों
zulfoon	ज़ुल्फ़ों
chhaanv	छाँव
chhaav	छाँव
chhaaon	छाँव
chhaanw	छाँव
chaanv	छाँव
chaon	छाँव
chhanv	छाँव
chaav	छाँव
chaaon	छाँव
dilakash	दिलकश
dilkash	दिलकश
lamha	लम्हा
lamhaa	लम्हा
bekhudi	बेखुदी
bekhudee	बेखुदी
bekhudii	बेखुदी
bekhudhi	बेखुदी
badla	बदला
badala	बदला
badalaa	बदला
badlaa	बदला
jitna	जितना
jitana	जितना
jitanaa	जितना
jitnaa	जितना
utna	उतना
utana	उतना
utanaa	उतना
kahate	कहते
kahete	कहते
kehte	कहते
kehtee	कहते
kehate	कहते
kahte	कहते
kahetey	कहते
kehtey	कहते
kehete	कहते
maana	माना
mana	माना
maanaa	माना
mazaa	माना
maangaa	माना
honthon	होंठों
honton	होंठों
hothon	होंठों
hoton	होंठों
hontho	होंठों
honthhon	होंठों
hooto	होंठों
hontonn	होंठों
honto	होंठों
paigaam	पैगाम
paigam	पैगाम
paigham	पैगाम
haseena	हसीना
hasina	हसीना
haseenaa	हसीना
hasinaa	हसीना
hasiinaa	हसीना
chori	चोरी
choree	चोरी
chorii	चोरी
aane	आने
ane	आने
apne	आने
zulfen	ज़ुल्फ़ें
zulfein	ज़ुल्फ़ें
zulfe	ज़ुल्फ़ें
zulfyein	ज़ुल्फ़ें
tevar	तेवर
milne	मिलने
milane	मिलने
milney	मिलने
miline	मिलने
tadpa	तड़पा
tadapa	तड़पा
tadapaa	तड़पा
tadpaa	तड़पा
chupke	चुपके
chupake	चुपके
chuppkee	चुपके
chhupke	चुपके
chhupake	चुपके
bola	बोला
bolaa	बोला
beete	बीते
bite	बीते
bete	बीते
biite	बीते
beeten	बीते
beetey	बीते
yaaron	यारों
yaaro	यारों
yaro	यारों
yaron	यारों
yarron	यारों
mujh	मुझ
muz	मुझ
mujhi	मुझ
muhj	मुझ
mujhe	मुझ
muhje	मुझ
mujho	मुझ
pata	पता
pataa	पता
patha	पता
pathar	पता
ptaa	पता
meena	मीना
mina	मीना
miinaa	मीना
minaa	मीना
giridhari	गिरिधारी
giridhaari	गिरिधारी
suun	सूँ
kahiyo	कहियो
ter	टेर
dig	दिग
layi	लाई
laai	लाई
laayi	लाई
laaii	लाई
lai	लाई
ldai	लाई
raadhika	राधिका
radhika	राधिका
sanvariya	सँवरिया
sanwariya	सँवरिया
tohe	तोहे
thohe	तोहे
garava	गरवा
garavaa	गरवा
garawaa	गरवा
garawa	गरवा
ras	रस
tore	तोरे
tora	तोरे
tohre	तोरे
jehi	जेही
chitavat	चितवत
chitawat	चितवत
tehi	तेही
kari	करी
karii	करी
raakhat	राखत
naahi	नाही
nahi	नाही
pade	पड़े
padhe	पड़े
maika	मैका
saajana	साजना
saajanaa	साजना
saajnaa	साजना
saajna	साजना
sajana	साजना
sajanaa	साजना
sajna	साजना
sanjana	साजना
kayaalon	ख़यालों
khayalon	ख़यालों
khayaalon	ख़यालों
kushbuu	ख़ुश्बू
kushbu	ख़ुश्बू
khushbu	ख़ुश्बू
reshami	रेशमी
reshmi	रेशमी
reshamii	रेशमी
raatein	रातें
raaten	रातें
raate	रातें
hongi	होंगी
hongii	होंगी
hogi	होंगी
hongee	होंगी
honge	होंगी
saugaatein	सौगातें
saugaate	सौगातें
saugaaten	सौगातें
raas	रास
prit	प्रीत
preet	प्रीत
priit	प्रीत
pareet	प्रीत
preeta	प्रीत
prita	प्रीत
paaye	प्रीत
preeth	प्रीत
kheli	खेली
khelii	खेली
akeli	अकेली
akelii	अकेली
aakeli	अकेली
akelee	अकेली
balam	बलम
baalam	बलम
beli	बेली
ji	जी
jee	जी
jii	जी
jai	जी
udaas	उदास
udhaas	उदास
udhas	उदास
waada	वादा
vaada	वादा
waadaa	वादा
wada	वादा
vaadaa	वादा
vada	वादा
wadaa	वादा
bada	वादा
mahine	महीने
maheene	महीने
mahiine	महीने
bairan	बैरन
deti	देती
detee	देती
detii	देती
waah	वाह
vaah	वाह
wah	वाह
vah	वाह
waha	वाह
balama	बलमा
balamaa	बलमा
balmaa	बलमा
balma	बलमा
baalamaa	बलमा
balmaan	बलमा
tuune	तूने
tune	तूने
toone	तूने
pherin	फेरीं
waron	वरों
li	ली
lii	ली
le	ली
tuut	टूट
tut	टूट
baithi	बैठी
baiti	बैठी
ganwa	गँवा
ganva	गँवा
ganvaa	गँवा
qisamat	क़िसमत
qismat	क़िसमत
waasta	वास्ता
vaasta	वास्ता
vaastaa	वास्ता
wasta	वास्ता
bairiya	बैरिया
papeeharaa	पपीहरा
papeehara	पपीहरा
palakon	पलकों
palkhon	पलकों
palkoon	पलकों
palkon	पलकों
palko	पलकों
palako	पलकों
boond	बूँद
bund	बूँद
buund	बूँद
sajaaye	सजाए
sajaae	सजाए
sajaye	सजाए
pee	पी
pii	पी
pi	पी
pe	पी
des	देस
desh	देस
sandesaa	संदेसा
sandesa	संदेसा
laaye	लाए
laae	लाए
laye	लाए
wijay	विजय
vijay	विजय
jay	जय
jaya	जय
pahale	पहले
pehle	पहले
pahle	पहले
pehale	पहले
pahele	पहले
pehele	पहले
phele	पहले
saaf	साफ़
maaf	माफ़
bache	बचे
mushkile	मुश्किलें
mushkilein	मुश्किलें
mushkilen	मुश्किलें
mukshkilein	मुश्किलें
karam	कर्म
karm	कर्म
pasina	पसीना
paseena	पसीना
pasinaa	पसीना
pasiinaa	पसीना
paseenaa	पसीना
yaar	यार
yaara	यार
yar	यार
yaad	यार
puuchhuunga	पूछूंगा
tan	तन
baraf	बरफ़
jigar	जिगर
jiger	जिगर
achaanak	अचानक
achanak	अचानक
paaya	पाया
paayaa	पाया
paya	पाया
abaki	अबकी
paaye	पाए
paae	पाए
paye	पाए
lipata	लिपटा
liptaa	लिपटा
lipta	लिपटा
khud	खुद
khuda	खुद
khudh	खुद
samajhaaye	समझाए
samjhaaye	समझाए
samjaaye	समझाए
samajhaae	समझाए
samjhaye	समझाए
chaahuun	चाहूं
chahoon	चाहूं
chaahoon	चाहूं
chaahon	चाहूं
luun	लूं
lun	लूं
gale	गले
gaale	गले
galey	गले
laakh	लाख
lakh	लाख
lak	लाख
sambhaala	सम्भाला
sambhala	सम्भाला
sambhaalaa	सम्भाला
matavaala	मतवाला
matvaala	मतवाला
matawaala	मतवाला
matawaalaa	मतवाला
matavaalaa	मतवाला
matwaala	मतवाला
matavala	मतवाला
matvaalaa	मतवाला
matwala	मतवाला
matwalla	मतवाला
pahali	पहली
pehli	पहली
pahalee	पहली
pahalii	पहली
pahli	पहली
pehali	पहली
paheli	पहली
pahele	पहली
peheli	पहली
pehle	पहली
mulaakaat	मुलाकात
mulaaqaat	मुलाकात
mulaakaata	मुलाकात
mulaakat	मुलाकात
mulakaat	मुलाकात
mulaqaat	मुलाकात
mulaaqat	मुलाकात
mulakat	मुलाकात
molaqat	मुलाकात
mulaqat	मुलाकात
hamane	हमने
hamne	हमने
humne	हमने
humane	हमने
hummne	हमने
chhoti	छोटी
chhotii	छोटी
choti	छोटी
banegi	बनेगी
banegii	बनेगी
banegee	बनेगी
bhola	भोला
bholaa	भोला
chor	चोर
chora	चोर
nazarein	नज़रें
nazaren	नज़रें
nazrein	नज़रें
nazren	नज़रें
chura	चुरा
churaa	चुरा
chehra	चुरा
luuta	लूटा
luta	लूटा
loota	लूटा
luutaa	लूटा
lootaa	लूटा
lutaa	लूटा
madahosh	मदहोश
madhosh	मदहोश
chhodo	छोड़ो
chodo	छोड़ो
chodho	छोड़ो
chhodho	छोड़ो
bura	बुरा
buraa	बुरा
bhura	बुरा
burraa	बुरा
boora	बुरा
begaana	बेगाना
begaanaa	बेगाना
begana	बेगाना
behgana	बेगाना
beghaanaa	बेगाना
tedha	टेढ़ा
teda	टेढ़ा
bairi	बैरी
bhari	बैरी
bairii	बैरी
maza	मज़ा
mazaa	मज़ा
mazza	मज़ा
intazaar	इंतज़ार
intezaar	इंतज़ार
intezar	इंतज़ार
intazar	इंतज़ार
intajaar	इंतज़ार
intzaar	इंतज़ार
takane	तकने
baitha	बैठा
baithaa	बैठा
baita	बैठा
ka	क
ke	क
k	क
ko	क
dastuur	दस्तूर
dastur	दस्तूर
dastoor	दस्तूर
halachal	हलचल
hulchul	हलचल
halchal	हलचल
hulchal	हलचल
halachala	हलचल
beqaraar	बेक़रार
bekaraar	बेक़रार
beqraar	बेक़रार
bekarar	बेक़रार
beqarar	बेक़रार
kahata	कहता
kehta	कहता
kahataa	कहता
kehata	कहता
kahetaa	कहता
kahtaa	कहता
kaheta	कहता
kahta	कहता
kehtaa	कहता
khata	कहता
kheta	कहता
aayega	आयेगा
aayegaa	आयेगा
aaegaa	आयेगा
ayega	आयेगा
aayenga	आयेगा
ae	अए
aye	अए
khaayega	खायेगा
khaayegaa	खायेगा
juuta	जूता
juta	जूता
usi	उसी
usee	उसी
ussi	उसी
usiki	उसी
usii	उसी
ushi	उसी
khaaya	खाया
khaya	खाया
khaayaa	खाया
qismat	क़िस्मत
qisamat	क़िस्मत
phere	फेरे
pere	फेरे
jeb	जेब
kati	कटी
katii	कटी
kaleja	कलेजा
kalejaa	कलेजा
hil	हिल
hill	हिल
maal	माल
sahi	सही
sahii	सही
sahee	सही
sehi	सही
bachi	बची
bachii	बची
bhaag	भाग
bhag	भाग
baag	भाग
mistar	मिस्टर
mister	मिस्टर
mem	मेम
phire	फिरे
fire	फिरे
kutta	कुत्ता
kuttaa	कुत्ता
jaanavar	जानवर
janwar	जानवर
jaanwar	जानवर
insaan	इन्सान
naazanin	नाज़नीं
naazaneen	नाज़नीं
naaznin	नाज़नीं
naazneen	नाज़नीं
naazaniin	नाज़नीं
naazanee	नाज़नीं
kaar	कार
kar	कार
baink	बैंक
tis	तीस
tees	तीस
this	तीस
hazaar	हज़ार
hajaar	हज़ार
hazar	हज़ार
tab	तब
taba	तब
kijiye	कीजिए
kiijie	कीजिए
kijeye	कीजिए
sarakaar	सरकार
sarkar	सरकार
sarkaar	सरकार
suut	सूट
sut	सूट
soot	सूट
boot	बूट
buut	बूट
raam	राम
ram	राम
rama	राम
raama	राम
jeeta	जीता
jita	जीता
jeetaa	जीता
jiitaa	जीता
jitaa	जीता
peeta	पीता
pita	पीता
saaki	साकी
pila	पिला
pilaa	पिला
botal	बोतल
bottle	बोतल
munh	मुंह
jagi	जगी
jaagi	जगी
khaali	खाली
khali	खाली
khaalii	खाली
mehalon	महलों
mahalon	महलों
mahalo	महलों
mahlon	महलों
mehlon	महलों
mehalo	महलों
galiyon	गलियों
galiyoon	गलियों
galiyo	गलियों
galeeyon	गलियों
jel	जेल
jhel	जेल
sabhi	सभी
sabi	सभी
jeete	जीते
jite	जीते
jiite	जीते
jithe	जीते
hoy	होय
hoye	होय
hona	होना
honaa	होना
gazal	गज़ल
ghazal	गज़ल
madmast	मदमस्त
madamast	मदमस्त
madmasta	मदमस्त
parvat	पर्वत
gulaam	गुलाम
ghulam	गुलाम
ghulaam	गुलाम
gulam	गुलाम
banjaaron	बंजारों
banjaron	बंजारों
banjaro	बंजारों
aavaaron	आवारों
jahaan	जहां
jahan	जहां
jahaa	जहां
soja	सोजा
sojaa	सोजा
vahaan	वहां
wahan	वहां
wahaa	वहां
vahan	वहां
wahaan	वहां
kisko	किसको
kisako	किसको
kisiko	किसको
intazaam	इंतज़ाम
khwaabon	ख्वाबों
khvaabon	ख्वाबों
khwaabo	ख्वाबों
khwabon	ख्वाबों
khaabon	ख्वाबों
saanson	साँसों
sasoon	साँसों
saansoin	साँसों
sanson	साँसों
saason	साँसों
saanso	साँसों
saasoon	साँसों
sanso	साँसों
sansoon	साँसों
sason	साँसों
kiye	किये
chhupa	छुपा
chhupaa	छुपा
chupa	छुपा
chhipaa	छुपा
chhupha	छुपा
chhuppa	छुपा
uda	उड़ा
udaa	उड़ा
udha	उड़ा
saja	सजा
sajaa	सजा
gunguna	गुनगुना
gungunaa	गुनगुना
gunagunaa	गुनगुना
gunaguna	गुनगुना
meet	मीत
miit	मीत
mit	मीत
mita	मीत
zubaan	ज़ुबां
shola	शोला
sholaa	शोला
shoola	शोला
kiska	किसका
kisakaa	किसका
kisaka	किसका
kiskaa	किसका
jal	जल
jala	जल
suno	सुनो
suuno	सुनो
liye	लिए
lie	लिए
khilta	खिलता
khilataa	खिलता
khilata	खिलता
khulta	खिलता
chalta	चलता
chalata	चलता
chalataa	चलता
nikalta	निकलता
nikalataa	निकलता
nikalata	निकलता
hamase	हमसे
humse	हमसे
hamse	हमसे
parada	परदा
pardaa	परदा
parda	परदा
paradaa	परदा
ruuth	रूठ
ruth	रूठ
chheda	छेड़ा
chhedaa	छेड़ा
gaur	गौर
sun	सुन
suun	सुन
suno	सुन
suna	सुन
lijiye	लीजिए
lijie	लीजिए
liijiye	लीजिए
lijeye	लीजिए
huzuur	हुज़ूर
huzur	हुज़ूर
huzoor	हुज़ूर
lenge	लेंगे
zaruur	ज़रूर
zaroor	ज़रूर
zarur	ज़रूर
zuroor	ज़रूर
tirachhi	तिरछी
tirchhi	तिरछी
nigaah	निगाह
nigah	निगाह
banaane	बनाने
banane	बनाने
faayada	फ़ायदा
faayda	फ़ायदा
faayadaa	फ़ायदा
fayda	फ़ायदा
sataane	सताने
satane	सताने
aji	अजी
ajii	अजी
ajee	अजी
aaji	अजी
ruutha	रूठा
rutha	रूठा
ruuthaa	रूठा
ruthaa	रूठा
baaton	बातों
baato	बातों
baton	बातों
bataoon	बातों
batoon	बातों
baatoon	बातों
socha	सोचा
sochaa	सोचा
soocha	सोचा
haan	हां
haa	हां
kahana	कहना
kehna	कहना
kahnaa	कहना
kahanaa	कहना
kahena	कहना
kehana	कहना
kehena	कहना
kahna	कहना
maanoge	मानोगे
manoge	मानोगे
duungi	दूंगी
doongi	दूंगी
dungi	दूंगी
lagaayi	लगाई
lagayi	लगाई
lagaaii	लगाई
lagaai	लगाई
lagai	लगाई
lagaay	लगाई
usaka	उसका
uska	उसका
usakaa	उसका
uskaa	उसका
parade	परदे
parde	परदे
pardey	परदे
dikha	दिखा
dikhaa	दिखा
logon	लोगों
logo	लोगों
jalave	जलवे
jalwe	जलवे
jalawe	जलवे
jalve	जलवे
jalven	जलवे
jalwen	जलवे
vyaayaamashaala	व्यायामशाला
vasha	वशा
samajhoge	समझोगे
samjhoge	समझोगे
aana	आना
ana	आना
chadhati	चढ़ती
chadhti	चढ़ती
chadti	चढ़ती
javaani	जवानी
jawani	जवानी
jawaani	जवानी
javaanii	जवानी
javaanee	जवानी
jawaanee	जवानी
javani	जवानी
jawaanii	जवानी
usape	उसपे
uspe	उसपे
mastaana	मस्ताना
mastana	मस्ताना
mastaanaa	मस्ताना
mastanaa	मस्ताना
masataanaa	मस्ताना
mauj	मौज
mouj	मौज
padein	पड़ें
paden	पड़ें
karana	करना
karna	करना
karanaa	करना
karnaa	करना
paake	पाके
pake	पाके
sajan	सजन
sajani	सजन
saajan	सजन
sajna	सजन
diladaar	दिलदार
dildaar	दिलदार
dildar	दिलदार
diladar	दिलदार
dildara	दिलदार
bachaayoge	बचाओगे
sakoge	सकोगे
bhulaayoge	भुलाओगे
bhulaoge	भुलाओगे
bhulaaoge	भुलाओगे
aayenge	आएँगे
aaenge	आएँगे
nindein	नींदें
ninde	नींदें
neendien	नींदें
niinden	नींदें
ninden	नींदें
neenden	नींदें
kvaabon	ख़्वाबों
khwaabo	ख़्वाबों
khwabon	ख़्वाबों
khwaabon	ख़्वाबों
khvaabon	ख़्वाबों
khwabo	ख़्वाबों
khwaaboh	ख़्वाबों
kwaabon	ख़्वाबों
ghul	घुल
tadapenge	तड़पेंगे
tadpenge	तड़पेंगे
tadapaayenge	तड़पाएँगे
sulag	सुलग
aakar	आकर
ashkon	अश्कों
laharaayenge	लहराएँगे
rahoon	रहूँ
rahuun	रहूँ
rahoo	रहूँ
rahun	रहूँ
rahon	रहूँ
judaa	जुदा
jooda	जुदा
juda	जुदा
jhuda	जुदा
honge	होंगे
hoge	होंगे
jyot	ज्योत
lahar	लहर
lehar	लहर
laher	लहर
leher	लहर
saaheel	साहिल
saahil	साहिल
sahil	साहिल
saheel	साहिल
nibhaayein	निभाएं
nibhaayen	निभाएं
nibhayein	निभाएं
jaan	जां
jan	जां
jaaa	जां
nam	नम
num	नम
jurm	जुर्म
jurma	जुर्म
paayi	पाई
paai	पाई
pai	पाई
payi	पाई
saza	सज़ा
sazaa	सज़ा
sangam	संगम
tujhpe	तुझपे
tujhape	तुझपे
tujpe	तुझपे
sitam	सितम
sitamb	सितम
situm	सितम
dusron	दूसरों
doosaron	दूसरों
paap	पाप
paapi	पाप
nirdosh	निर्दोष
naari	नारी
naara	नारी
nari	नारी
naaree	नारी
naarii	नारी
naree	नारी
sahe	सहे
jhukaaye	झुकाए
jhukaye	झुकाए
jhukaae	झुकाए
chup	चुप
chupe	चुप
chupp	चुप
chhup	चुप
reet	रीत
rit	रीत
riit	रीत
rasm	रस्म
ilaaj	इलाज़
peeti	पीती
piti	पीती
piitii	पीती
jeeti	जीती
jiitii	जीती
jeetee	जीती
jiti	जीती
khaas	खास
resham	रेशम
hawaaon	हवाओं
havaaon	हवाओं
hawaon	हवाओं
havaayon	हवाओं
hawavon	हवाओं
havaon	हवाओं
hawaayon	हवाओं
hawao	हवाओं
havaoon	हवाओं
hawaao	हवाओं
fizaaon	फ़िज़ाओं
fizaao	फ़िज़ाओं
fizaoon	फ़िज़ाओं
fijaaon	फ़िज़ाओं
fizaayon	फ़िज़ाओं
fizaon	फ़िज़ाओं
fizao	फ़िज़ाओं
ankahee	अनकही
ankahi	अनकही
utarne	उतरने
parinde	परिन्दे
gaane	गाने
gane	गाने
manzar	मंज़र
suhaani	सुहाने
suhaane	सुहाने
suhane	सुहाने
manzilon	मंज़िलों
manjilon	मंज़िलों
manzilo	मंज़िलों
raaste	रास्ते
raste	रास्ते
raasate	रास्ते
raasten	रास्ते
rastey	रास्ते
shukriya	शुक्रिया
shukriyaa	शुक्रिया
jitne	जितने
jitane	जितने
khwaab	ख्वाब
khwab	ख्वाब
khvab	ख्वाब
khvaab	ख्वाब
kwaab	ख्वाब
khwaabon	ख्वाब
khaab	ख्वाब
khavaab	ख्वाब
khawab	ख्वाब
jagaa	जगा
jaga	जगा
armaan	अरमां
aramaan	अरमां
arman	अरमां
bandhan	बंधन
bandan	बंधन
milke	मिलके
milake	मिलके
bulaaya	बुलाया
bulaayaa	बुलाया
bulaya	बुलाया
choli	चोली
cholii	चोली
dariya	दरिया
darya	दरिया
dariyaa	दरिया
dareeyaa	दरिया
dariyaan	दरिया
dariyan	दरिया
sargam	सरगम
saragam	सरगम
sargaam	सरगम
saragama	सरगम
yun	यूं
yuun	यूं
youn	यूं
you	यूं
marate	मरते
marte	मरते
jinake	जिनके
jinke	जिनके
jhinke	जिनके
karen	करें
karein	करें
karyein	करें
charen	करें
karey	करें
davaa	दवा
dawa	दवा
dawaan	दवा
dava	दवा
dawaa	दवा
jinhen	जिन्हें
jinhein	जिन्हें
nindon	नींदों
niindon	नींदों
neendon	नींदों
paalaa	पाला
paala	पाला
ujaalaa	उजाला
ujaala	उजाला
ujala	उजाला
betaab	बेताब
betab	बेताब
maanate	मानते
maante	मानते
voh	वोह
woh	वोह
ishaaron	इशारों
isharon	इशारों
ishaaro	इशारों
zamaane	ज़माने
zamane	ज़माने
jamaane	ज़माने
jamane	ज़माने
zamano	ज़माने
unhen	उन्हें
unhein	उन्हें
unhey	उन्हें
dhadakanon	धड़कनों
dhadkanon	धड़कनों
rakhaa	रखा
rakha	रखा
aainaa	आइना
aaina	आइना
aina	आइना
kudaa	ख़ुदा
khudaa	ख़ुदा
khuda	ख़ुदा
kuda	ख़ुदा
khudha	ख़ुदा
maangi	माँगी
maangee	माँगी
manghi	माँगी
mangi	माँगी
hai	हि
hi	हि
hii	हि
jinaki	जिनकी
jinki	जिनकी
jinakii	जिनकी
paagal	पागल
pagal	पागल
pagel	पागल
haalat	हालत
halat	हालत
tadapati	तड़पती
tadapti	तड़पती
keh	केह
aayenge	आयेंगे
ayenge	आयेंगे
aayange	आयेंगे
aaenge	आयेंगे
tadapate	तड़पते
tadapte	तड़पते
paa	पा
pa	पा
pav	पा
pal	पा
paal	पा
rahenge	रहेंगे
rehenge	रहेंगे
raheinge	रहेंगे
paaye	पाये
paye	पाये
chhin	छीन
chin	छीन
unake	उनके
unke	उनके
chaahenge	चाहेंगे
chahenge	चाहेंगे
poojenge	पूजेंगे
banaayenge	बनाएँगे
sune	सूने
suune	सूने
soone	सूने
khushiyaan	ख़ुशियाँ
kushiyaan	ख़ुशियाँ
khushiyan	ख़ुशियाँ
paraaye	पराये
paraye	पराये
padataa	पड़ता
padata	पड़ता
padta	पड़ता
chalo	चलो
chalho	चलो
basaayenge	बसाएँगे
basayenge	बसाएँगे
andheraa	अँधेरा
andhera	अँधेरा
utane	उतने
ujaale	उजाले
ujale	उजाले
ujaalon	उजाले
jagaanaa	जगाना
jagaana	जगाना
jaaye	जाएँ
jaayein	जाएँ
jaayen	जाएँ
jaaen	जाएँ
jaaein	जाएँ
jaye	जाएँ
jayein	जाएँ
jayen	जाएँ
fulon	फूलों
phuulon	फूलों
foolon	फूलों
phulon	फूलों
pholon	फूलों
janam	जनम
lagaayenge	लगाएँगे
lagayenge	लगाएँगे
waade	वादे
vaade	वादे
waadey	वादे
vade	वादे
vaadepe	वादे
wade	वादे
aramaan	अरमाँ
armaan	अरमाँ
armaaan	अरमाँ
armanan	अरमाँ
melaa	मेला
mela	मेला
bahaaron	बहारों
baharon	बहारों
baharoon	बहारों
baharo	बहारों
bahaaro	बहारों
bhaaron	बहारों
saaraa	सारा
saara	सारा
sara	सारा
saraaaa	सारा
gulashan	गुलशन
gulshan	गुलशन
daalaa	डाला
daala	डाला
dala	डाला
dalaa	डाला
khilaao	खिलाओ
ro	रो
hasaao	हँसाओ
base	बसे
jhukana	झुकाना
jhukaanaa	झुकाना
jhukaana	झुकाना
pada	पड़ा
padha	पड़ा
padaa	पड़ा
pukara	पुकारा
pukaara	पुकारा
pukaaraa	पुकारा
pukaraa	पुकारा
isme	इसमें
isamein	इसमें
ismein	इसमें
isamen	इसमें
isamain	इसमें
kisliye	किसलिए
kisalie	किसलिए
kisaliye	किसलिए
bekarari	बेक़रारी
beqaraari	बेक़रारी
beqarari	बेक़रारी
beqaraarii	बेक़रारी
beqraari	बेक़रारी
bekaraari	बेक़रारी
abhi	अभी
abhee	अभी
abhii	अभी
abh	अभी
abi	अभी
idhar	इधर
idher	इधर
badalna	बदलना
badalana	बदलना
badalanaa	बदलना
chiz	चीज़
chiiz	चीज़
izzat	इज़्ज़त
chandi	चाँदी
chaandi	चाँदी
chaandii	चाँदी
chaandee	चाँदी
bahalaye	बहलाए
bahalaae	बहलाए
behalaaye	बहलाए
bahalaaye	बहलाए
bahelaaye	बहलाए
bahlaaye	बहलाए
behlaave	बहलाए
behlaawe	बहलाए
daulat	दौलत
doulat	दौलत
chaman	चमन
chuman	चमन
kali	कली
kalli	कली
kalii	कली
chali	कली
nikhar	निखार
nikaah	निखार
nikhaar	निखार
huye	हुए
hue	हुए
huee	हुए
huey	हुए
huen	हुए
huae	हुए
hua	हुए
caravan	कारवाँ
kaaravaan	कारवाँ
kaarawaan	कारवाँ
kaarvan	कारवाँ
kaarwaan	कारवाँ
caarvaan	कारवाँ
kaarava	कारवाँ
kaarvaan	कारवाँ
karvan	कारवाँ
caaravaan	कारवाँ
karwaa	कारवाँ
karawa	कारवाँ
karwaan	कारवाँ
karvaan	कारवाँ
kaarwan	कारवाँ
baitho	बैठो
beato	बैठो
jaano	जानो
jano	जानो
bheegi	भीगी
bhigi	भीगी
bhiigi	भीगी
beeigi	भीगी
raaton	रातों
raato	रातों
raatoon	रातों
raton	रातों
ratoon	रातों
tapte	तपते
tapate	तपते
doonga	दूंगा
duungaa	दूंगा
dunga	दूंगा
duunga	दूंगा
doongaa	दूंगा
mehrabaan	मेहरबाँ
meharabaan	मेहरबाँ
meharbaan	मेहरबाँ
meherbaan	मेहरबाँ
meherbaa	मेहरबाँ
sahara	सहारा
sahaaraa	सहारा
sahaara	सहारा
sehara	सहारा
bhuule	भूले
bhule	भूले
suriilaa	सुरीला
sureela	सुरीला
surila	सुरीला
khoe	खोए
ajanabii	अजनबी
ajanabi	अजनबी
ajnabi	अजनबी
ajnabee	अजनबी
ajanabee	अजनबी
ajanbi	अजनबी
dekhkar	देखकर
dekhakar	देखकर
fareb	फ़रेब
khaane	खाने
khaaye	खाने
naaraaz	नाराज़
naraj	नाराज़
naaraz	नाराज़
naaraaj	नाराज़
aadat	आदत
adat	आदत
muskuraane	मुस्कुराने
muskurane	मुस्कुराने
muskuraaye	मुस्कुराने
zulmaton	ज़ुल्मतों
sharaabkhane	शराबख़ाने
hasraton	हसरतों
hasaraton	हसरतों
daag	दाग़
dag	दाग़
aansuon	आँसुओं
aasuon	आँसुओं
aansuyon	आँसुओं
aansuwon	आँसुओं
aansuo	आँसुओं
boliye	बोलिये
kaar	ख़ार
saadagi	सादगी
saadgi	सादगी
saadagii	सादगी
baaraha	बारहा
baarha	बारहा
chubho	चुभो
ambareen	अम्बरीं
khumaar	खुमार
khumhar	खुमार
humaar	खुमार
kholiye	खोलिये
kaatana	काटना
adam	अदम
jaag	जाग
jag	जाग
jaaga	जाग
jaagta	जाग
diye	दिये
takte	तकते
takate	तकते
rahana	रहना
rehna	रहना
rahnaa	रहना
rehana	रहना
rahanaa	रहना
rahena	रहना
rehnaa	रहना
rehanaa	रहना
rehena	रहना
rahna	रहना
bajne	बजने
bajane	बजने
lageen	लगीं
lagin	लगीं
lagee	लगीं
lagiin	लगीं
hijr	हिज्र
sannaate	सन्नाटे
sannate	सन्नाटे
gunagunaata	गुनगुनाता
gungunaata	गुनगुनाता
gardish	गर्दिश
dauraan	दौराँ
sataaya	सताया
sataya	सताया
sataayaa	सताया
jaanib	जानिब
ayyaam	अय्याम
saaqi	साक़ी
saaqii	साक़ी
saqi	साक़ी
thodi	थोड़ी
takleef	तकलीफ़
takalif	तकलीफ़
takaleef	तकलीफ़
saagar	साग़र
sagar	साग़र
sunake	सुनके
sunke	सुनके
tabeeyat	तबीयत
tabiyat	तबीयत
tabiiyat	तबीयत
dilawaalon	दिलवालो
dilwaalon	दिलवालो
hadd	हद्द
viraani	वीरानी
veeraani	वीरानी
virani	वीरानी
viiraanii	वीरानी
chalegi	चलेगी
chalengi	चलेगी
chaat	चाट
basti	बस्ती
bastii	बस्ती
basthi	बस्ती
basegi	बसेगी
basegee	बसेगी
andar	अंदर
ander	अंदर
andhar	अंदर
jangal	जंगल
jungel	जंगल
jungle	जंगल
jungal	जंगल
sannaata	सन्नाटा
haathon	हाथों
hathon	हाथों
haaton	हाथों
haathoon	हाथों
rahegi	रहेगी
rahegee	रहेगी
rahegii	रहेगी
rahengi	रहेगी
razi	रज़ि
miyaan	मियाँ
miya	मियाँ
miyaa	मियाँ
bolo	बोलो
boloe	बोलो
bemurawwat	बेमुरव्वत
bemuravvat	बेमुरव्वत
jama	जमा
zama	जमा
jamah	जमा
jamaa	जमा
bismil	बिस्मिल
tanha	तन्हा
tanhaa	तन्हा
qaatil	क़ातिल
qatil	क़ातिल
hansi	हँसी
hansii	हँसी
hansee	हँसी
chhaale	छाले
chaale	छाले
chhale	छाले
wohi	वोही
wohii	वोही
vohi	वोही
vohii	वोही
log	लोग
loog	लोग
waale	वाले
vaale	वाले
wale	वाले
vale	वाले
waley	वाले
waalon	वाले
waali	वाले
waaleee	वाले
walen	वाले
chaahane	चाहने
chaahne	चाहने
chahane	चाहने
chahne	चाहने
andaaz	अन्दाज़
andaz	अन्दाज़
may	मय
barasati	बरसती
barasatee	बरसती
barasti	बरसती
taari	तारी
uchhaale	उछाले
unase	उनसे
unse	उनसे
unnse	उनसे
zist	ज़ीस्त
ziist	ज़ीस्त
ada	अदा
adaa	अदा
addaa	अदा
shaayad	शायद
shayad	शायद
ashq	अश्क़
sambhaale	सम्भाले
sambaale	सम्भाले
sambhale	सम्भाले
jalwaagah	जल्वागह
kabar	ख़बर
sunaauun	सुनाऊँ
sunaaoo	सुनाऊँ
sunaayuun	सुनाऊँ
sunaau	सुनाऊँ
sunaaun	सुनाऊँ
sunao	सुनाऊँ
sunaaoon	सुनाऊँ
sunaoon	सुनाऊँ
sunaao	सुनाऊँ
bujhataa	बुझता
buzataa	बुझता
bujhata	बुझता
bujhta	बुझता
charaag	चराग़
chiraag	चराग़
charag	चराग़
mazaar	मज़ार
majaar	मज़ार
mazaara	मज़ार
jaauun	जाऊँ
jaaoo	जाऊँ
jaayuun	जाऊँ
jaaun	जाऊँ
jaaoon	जाऊँ
jaun	जाऊँ
jaoon	जाऊँ
jaayun	जाऊँ
jaaon	जाऊँ
jaon	जाऊँ
zaaun	जाऊँ
jaao	जाऊँ
bhuulataa	भूलता
bhuulata	भूलता
bhulataa	भूलता
bhulata	भूलता
uthaa	उठा
utha	उठा
uthha	उठा
janaazaa	जनाज़ा
janaajaa	जनाज़ा
janaaza	जनाज़ा
dushman	दुश्मन
dusman	दुश्मन
dushaman	दुश्मन
khudaa	खुदा
khuda	खुदा
kudaa	खुदा
jinhe	जिन्हे
saharaa	सहरा
sahara	सहरा
sehra	सहरा
sahraa	सहरा
seharaa	सहरा
sehraa	सहरा
sahra	सहरा
aake	आके
ake	आके
thikaanaa	ठिकाना
thhikaanaa	ठिकाना
thikana	ठिकाना
thikaana	ठिकाना
thhikaana	ठिकाना
tikhana	ठिकाना
tikana	ठिकाना
bhuulaane	भूलाने
bhoolaane	भूलाने
bahaanaa	बहाना
bahaana	बहाना
bahana	बहाना
bahane	बहाना
samajhuun	समझूँ
samajhun	समझूँ
samajhoon	समझूँ
sansaar	संसार
sansar	संसार
baazii	बाज़ी
baazi	बाज़ी
haarake	हारके
bichhade	बिछड़े
bichhde	बिछड़े
bichade	बिछड़े
bichde	बिछड़े
bahaataa	बहाता
bahata	बहाता
bahaata	बहाता
bulaataa	बुलाता
bulaata	बुलाता
bulata	बुलाता
jod	जोड़
parabat	पर्बत
parbat	पर्बत
kahiye	कहिए
kahie	कहिए
rahiye	रहिए
bhuliye	भूलिए
bhuuliye	भूलिए
bhuulie	भूलिए
kheliye	खेलिए
giri	गिरी
girii	गिरी
chodkar	छोड़कर
chhodakar	छोड़कर
gayi	गईं
gaya	गईं
gayee	गईं
gayaa	गईं
gaye	गईं
parivesh	परिवेश
basa	बसा
basaa	बसा
naya	नया
nayaa	नया
nikale	निकले
nikle	निकले
aasaan	आसान
aasan	आसान
kaate	काटे
kate	काटे
vaaris	वारिस
fasalen	फ़सलें
bo	बो
sakta	सकता
sakata	सकता
sakataa	सकता
saqta	सकता
tujhase	तुझसे
tujhse	तुझसे
tujse	तुझसे
hamba	हम्बा
lila	लिला
lilo	लिलो
lile	लिले
chukuma	चुकुमा
tukuma	तुकुमा
chile	चिले
sabko	सबको
sabako	सबको
sabhko	सबको
sach	सच
such	सच
sacha	सच
bekhabar	बेखबर
aitbaar	ऐतबार
aitabaar	ऐतबार
etbaar	ऐतबार
nemat	नेमत
neemat	नेमत
milti	मिलती
milati	मिलती
milatii	मिलती
milatee	मिलती
milte	मिलती
miltee	मिलती
ise	इसे
isse	इसे
iske	इसे
khona	खोना
baad	बाद
bad	बाद
baaad	बाद
rona	रोना
ronaa	रोना
saansen	साँसें
saansein	साँसें
saasen	साँसें
saanse	साँसें
saasein	साँसें
sansein	साँसें
saase	साँसें
sansen	साँसें
ladi	लड़ी
ladii	लड़ी
inako	इनको
inko	इनको
piro	पिरो
peero	पिरो
jaati	जाती
jaatii	जाती
jaatee	जाती
jati	जाती
jate	जाती
jhatke	जाती
jaatey	जाती
jaate	जाती
santosh	संतोष
aadmi	आदमी
aadami	आदमी
karne	करने
karane	करने
taaqat	ताक़त
paisa	पैसा
paisaa	पैसा
jisne	जिसने
jisane	जिसने
kismat	किस्मत
qismat	किस्मत
kismata	किस्मत
kahe	कहे
kahee	कहे
kaahe	कहे
mehnat	मेहनत
mehanat	मेहनत
daag	दाग
dost	दोस्त
dosti	दोस्ती
dostii	दोस्ती
barso	बरसों
barason	बरसों
barson	बरसों
baraso	बरसों
barsoon	बरसों
version	बरसों
purana	पुराना
puraana	पुराना
puraanaa	पुराना
yarana	याराना
yaaraana	याराना
yaarana	याराना
yaaraa	याराना
rab	रब
raba	रब
rabb	रब
rabh	रब
gira	गिरा
giraa	गिरा
ghira	गिरा
bahaya	बहाया
behaya	बहाया
lahu	लहू
lahoo	लहू
lahuu	लहू
pujari	पुजारी
pujaari	पुजारी
pujaarii	पुजारी
poojari	पुजारी
pujaaree	पुजारी
mandir	मंदिर
laharon	लहरों
leharon	लहरों
lehron	लहरों
leheron	लहरों
laheron	लहरों
leharo	लहरों
lahero	लहरों
jyon	ज्यों
gire	गिरे
ghire	गिरे
lakiren	लकीरें
lakirein	लकीरें
lakeeren	लकीरें
lakeerein	लकीरें
ret	रेत
reeth	रेत
raet	रेत
deewar	दीवार
deewaar	दीवार
divaar	दीवार
diwaar	दीवार
deevaar	दीवार
diivaar	दीवार
deevar	दीवार
dewaar	दीवार
divar	दीवार
yaari	यारी
yaarii	यारी
yaara	यारी
yari	यारी
baddua	बद्दुआ
bhai	भाई
bhaai	भाई
note	नोट
not	नोट
chap	छप
rahele	रहेले
baaraat	बारात
baraat	बारात
baarat	बारात
barat	बारात
barsaat	बारात
baaraata	बारात
paison	पैसों
paiso	पैसों
barsaat	बरसात
barasaat	बरसात
barsat	बरसात
naseeba	नसीबा
naseebaa	नसीबा
nasiba	नसीबा
chappar	छप्पर
kiti	किती
dik	दिक
taana	ताना
tana	ताना
taanaa	ताना
tikna	तिकना
bangala	बंगला
bangla	बंगला
bangalaa	बंगला
gaadi	गाड़ी
gaadhi	गाड़ी
gaadii	गाड़ी
gadi	गाड़ी
ghadi	गाड़ी
baadi	बाड़ी
jog	जोग
jogi	जोग
khana	खाना
khaana	खाना
khaanaa	खाना
chappan	छप्पन
bhog	भोग
pista	पिस्ता
pishtaa	पिस्ता
pishta	पिस्ता
baadaam	बादाम
sej	सेज
sez	सेज
shej	सेज
saji	सजी
sajii	सजी
wali	वाली
vaali	वाली
waalee	वाली
waali	वाली
vali	वाली
vaalii	वाली
vaalee	वाली
waalii	वाली
wale	वाली
he	ह
ha	ह
h	ह
ho	ह
hai	हा
ha	हा
haa	हा
haaa	हा
haal	हा
haan	हा
har	हा
ham	हा
marne	मरने
marane	मरने
marney	मरने
marrne	मरने
he	हे
hue	हे
jabse	जबसे
jabase	जबसे
betaabi	बेताबी
betaabee	बेताबी
betaabii	बेताबी
beetabi	बेताबी
bikhare	बिखरे
bikhre	बिखरे
bhikre	बिखरे
roko	रोको
hadh	हद
had	हद
hudd	हद
hadd	हद
guzarane	गुज़रने
guzarne	गुज़रने
baje	बजे
bajee	बजे
cham	छम
chama	छमा
mujhpe	मुझपे
mujhape	मुझपे
muhjpe	मुझपे
kudiyan	कुड़ियां
kudiyaan	कुड़ियां
mujhme	मुझमें
mujhamein	मुझमें
mujhamen	मुझमें
mujhumein	मुझमें
mujhmein	मुझमें
bachke	बचके
bachake	बचके
inka	इनका
einka	इनका
inaka	इनका
inakaa	इनका
inkaa	इनका
leta	लेता
letaa	लेता
dhun	धुन
machalane	मचलने
machalne	मचलने
taraasha	तराशा
tarasha	तराशा
zaakir	ज़ाकिर
tabala	तबला
tabalaa	तबला
tabla	तबला
sona	सोना
sonaa	सोना
chamake	चमके
chamke	चमके
bramha	ब्रम्हा
rachaaya	रचाया
rachaayaa	रचाया
rimajhim	रिमझिम
rimjhim	रिमझिम
rimjim	रिमझिम
sajata	सजता
sajta	सजता
rahin	रहीं
raheen	रहीं
rahiin	रहीं
bichhada	बिछड़ा
bichhda	बिछड़ा
bichhadaa	बिछड़ा
bichda	बिछड़ा
bahati	बहती
behti	बहती
behati	बहती
behethi	बहती
bahatii	बहती
baheti	बहती
havaayein	हवायें
hawaayen	हवायें
hawaayein	हवायें
havaayen	हवायें
hawaaye	हवायें
hawayein	हवायें
band	बंद
bund	बंद
bandh	बंद
vaadi	वादी
waadi	वादी
vaadee	वादी
vaadii	वादी
waadee	वादी
gori	गोरि
dubaana	डुबाना
sharmaana	शर्माना
sharmaanaa	शर्माना
lene	लेने
duunga	दूँगा
dunga	दूँगा
doonga	दूँगा
dungaa	दूँगा
duungaa	दूँगा
doongaa	दूँगा
gajara	गजरा
gajaraa	गजरा
gajra	गजरा
girane	गिरने
girne	गिरने
ghirane	गिरने
murajhaane	मुरझाने
alaava	अलावा
bulaana	बुलाना
bulaanaa	बुलाना
bhulana	बुलाना
mard	मर्द
chhoduunga	छोड़ूँगा
chodunga	छोड़ूँगा
chhodoonga	छोड़ूँगा
chodoonga	छोड़ूँगा
chhodoongaa	छोड़ूँगा
udane	उड़ने
udne	उड़ने
udhane	उड़ने
luunga	लूँगा
loonga	लूँगा
lungaa	लूँगा
lunga	लूँगा
loongaa	लूँगा
luungaa	लूँगा
lounga	लूँगा
pyaar	पार
paar	पार
pyaara	पार
par	पार
kashtiyaan	कश्तियाँ
lad	लड़
mastiyaan	मस्तियाँ
mastiyan	मस्तियाँ
ladate	लड़ते
ladte	लड़ते
talavaarein	तलवारें
talawaarein	तलवारें
talawaaren	तलवारें
angaare	अंगारे
angaarey	अंगारे
bhigega	भीगेगा
gaalon	गालों
gaalo	गालों
rangoli	रंगोली
vahaan	वहाँ
wahaan	वहाँ
wahaa	वहाँ
wahan	वहाँ
vahan	वहाँ
jang	जंग
jung	जंग
jaanein	जानें
jaanen	जानें
jane	जानें
jaane	जानें
guzaara	गुज़ारा
guzaaraa	गुज़ारा
guzara	गुज़ारा
guzaraa	गुज़ारा
tabase	तबसे
kaabon	ख़ाबों
khwabon	ख़ाबों
khaabon	ख़ाबों
saajan	साजन
sajan	साजन
sajna	साजन
sajaan	साजन
saajana	साजन
bichhad	बिछड़
bichad	बिछड़
bichar	बिछड़
bhichar	बिछड़
bhichad	बिछड़
vaaste	वास्ते
waaste	वास्ते
waasate	वास्ते
jyuun	ज्यूँ
vaisi	वैसी
vaisii	वैसी
waisi	वैसी
waisee	वैसी
waise	वैसी
paanvon	पाँवों
paaon	पाँवों
paayal	पायल
payal	पायल
paayala	पायल
kaajal	काजल
kajal	काजल
kaajala	काजल
maaya	माया
maayaa	माया
maya	माया
machhindra	मछिंद्रा
mantar	मन्तर
pyaasa	प्यासा
pyaasaa	प्यासा
pyasa	प्यासा
payasaa	प्यासा
pagal	पगल
jaye	जये
jaaye	जये
mistari	मिस्तरी
shaastari	शास्तरी
bitegi	बीतेगी
beetegi	बीतेगी
biitegii	बीतेगी
beetengi	बीतेगी
raatari	रातरी
phulvaari	फुल्वारी
mardaana	मर्दाना
mastaani	मस्तानी
mastani	मस्तानी
mastaanii	मस्तानी
mastaanee	मस्तानी
masataani	मस्तानी
baja	बजा
bajaa	बजा
baaja	बजा
sundari	सुन्दरी
sundarii	सुन्दरी
baansuri	बाँसुरी
bansuri	बाँसुरी
baasuree	बाँसुरी
baansurii	बाँसुरी
baansuree	बाँसुरी
padane	पड़ने
padne	पड़ने
baalam	बालम
balam	बालम
baalama	बालम
baantane	बाँतने
chuumane	चूमने
choomne	चूमने
rog	रोग
rooga	रोग
rogi	रोग
milana	मिलना
milna	मिलना
milanaa	मिलना
dhin	धिन
din	धिन
dhinna	धिन्ना
minamekh	मीनमेख
chhokara	छोकरा
puuchhuun	पूछूँ
poochhuun	पूछूँ
puchhun	पूछूँ
poochhun	पूछूँ
raaja	राजा
raja	राजा
raajaa	राजा
raza	राजा
bhuula	भूला
bhulaa	भूला
bhula	भूला
bhuulaa	भूला
savaal	सवाल
sawaal	सवाल
sawal	सवाल
kaamadev	कामदेव
kaaamdev	कामदेव
rukata	रुकता
rukataa	रुकता
rukta	रुकता
rukhtha	रुकता
barf	बर्फ़
baraf	बर्फ़
pighalenge	पिघलेंगे
kavita	कविता
kavitaa	कविता
kawitaa	कविता
kawita	कविता
sohini	सोहिनी
mohini	मोहिनी
tanda	तंदा
ta	ता
taa	ता
tha	ता
tai	ता
gaati	गाती
gaatee	गाती
gaatii	गाती
kutiya	कुटिया
kutiyaa	कुटिया
svarg	स्वर्ग
swarg	स्वर्ग
svarga	स्वर्ग
swarga	स्वर्ग
chhote	छोटे
chote	छोटे
chhotte	छोटे
bahata	बहता
behta	बहता
baheta	बहता
bahataa	बहता
behata	बहता
udana	उड़ना
udna	उड़ना
patta	पट्टा
kaahe	काहे
kahe	काहे
kaafi	काफ़ी
kafi	काफ़ी
kaafii	काफ़ी
vaisa	वैसा
vaisaa	वैसा
waisa	वैसा
aasamaanon	आसमानों
aasmanon	आसमानों
aasmaanon	आसमानों
aasmaano	आसमानों
mitti	मिट्टी
chir	चीर
chiir	चीर
cheer	चीर
ankur	अंकुर
sardi	सर्दी
sardii	सर्दी
varsha	वर्षा
bhuumi	भूमि
bhumi	भूमि
agale	अगले
aagle	अगले
agle	अगले
milo	मिलो
garmi	गर्मी
garmee	गर्मी
garmii	गर्मी
apanepan	अपनेपन
apnepan	अपनेपन
mudake	मुड़के
mudke	मुड़के
lagati	लगती
lagti	लगती
lgati	लगती
lagatii	लगती
lagate	लगती
duubi	डूबी
dubhi	डूबी
dubi	डूबी
dhubi	डूबी
duubii	डूबी
bahut	बहुत
bohut	बहुत
sabab	सबब
koi	कोइ
ruuthi	रूठी
roti	रूठी
ruthi	रूठी
biti	बीती
beeti	बीती
biitii	बीती
beete	बीती
beti	बीती
bithi	बीती
bite	बीती
chaahiye	चाहिए
chahiye	चाहिए
chaahiyen	चाहिए
chaahie	चाहिए
aate	आते
ate	आते
pranaam	प्रणाम
pranam	प्रणाम
chaahiye	चाहिये
chahiye	चाहिये
chahiyee	चाहिये
chaaheeye	चाहिये
chaahie	चाहिये
sukhon	सुखों
daata	दाता
daataa	दाता
data	दाता
bigad	बिगड़
bighad	बिगड़
kaalika	कालिका
maata	माता
maataa	माता
mata	माता
naukari	नौकरी
naukri	नौकरी
naukarii	नौकरी
bich	बीच
beech	बीच
biich	बीच
bichh	बीच
jhole	झोले
naukariya	नौकरिया
banaaye	बनाए
banaae	बनाए
banaye	बनाए
rakhane	रखने
rakhne	रखने
shrimati	श्रीमती
shaadi	शादी
saalagirah	सालगिरह
baahar	बाहर
bahar	बाहर
baahr	बाहर
hotal	होटल
hotel	होटल
banaayega	बनाएगा
banayega	बनाएगा
pakaayega	पकाएगा
pakaayuunga	पकाऊंगा
ungali	उंगली
ungli	उंगली
ungalii	उंगली
chaategi	चाटेगी
chaaval	चावल
chaval	चावल
daal	दाल
ya	य
y	य
kela	केला
keli	केली
karela	करेला
kareli	करेली
muuli	मूली
bichaari	बिचारी
bichaaree	बिचारी
chatapata	चटपटा
masaaledaar	मसालेदार
pukaarein	पुकारें
pukaaren	पुकारें
pukaare	पुकारें
pukaren	पुकारें
pukare	पुकारें
chaar	चार
chada	चार
char	चार
khuli	खुली
khulii	खुली
baji	बजी
bajii	बजी
laila	लैला
chamiyya	छमिया
chhamiya	छमिया
chaila	छैला
nehlaa	नहला
nahala	नहला
nehala	नहला
nehla	नहला
dehlaa	दहला
dehla	दहला
dahala	दहला
jawan	जवां
jawaan	जवां
javaan	जवां
javan	जवां
phela	पहला
pehla	पहला
pahala	पहला
pahalaa	पहला
pahela	पहला
pahlaa	पहला
pehlaa	पहला
pehala	पहला
churayega	चुराएगा
churaayega	चुराएगा
muskurayega	मुस्कुराएगा
muskurayegaa	मुस्कुराएगा
muskuraaegaa	मुस्कुराएगा
aashiqui	आशिक़ी
aashiqi	आशिक़ी
aashiqii	आशिक़ी
ashiqui	आशिक़ी
beqaraar	बेकरार
bekarar	बेकरार
bekaraar	बेकरार
bekraar	बेकरार
beqarar	बेकरार
chiki	चिकी
chikii	चिकी
chak	चक
chaka	चक
muskurake	मुस्कुराके
muskuraake	मुस्कुराके
di	दी
de	दी
dii	दी
gud	गुड़
kha	खा
kaa	खा
ka	खा
hikko	हिक्को
nikko	निक्को
ni	नी
mulaakaaton	मुलाकातों
mulakaato	मुलाकातों
mulakaaton	मुलाकातों
mulakaton	मुलाकातों
kahaniya	कहानियां
kahaniyon	कहानियां
kahaaniyaan	कहानियां
kahaaniya	कहानियां
rahoge	रहोगे
yaadon	यादों
yaado	यादों
yadoon	यादों
yado	यादों
nishaniya	निशानियां
nishaaniyaan	निशानियां
sawalon	सवालों
savaalon	सवालों
sawaalon	सवालों
savalon	सवालों
jismein	जिसमें
jisamein	जिसमें
jisamen	जिसमें
jisme	जिसमें
jisame	जिसमें
kitaab	किताब
kitab	किताब
deewane	दीवाने
divaane	दीवाने
deevaane	दीवाने
diivaane	दीवाने
deewaane	दीवाने
dewane	दीवाने
dewaane	दीवाने
diwaane	दीवाने
diwane	दीवाने
divane	दीवाने
diwaaney	दीवाने
chuke	चुके
isiliye	इसीलिए
isiiliye	इसीलिए
isiilie	इसीलिए
itarake	इतराके
jhuthi	झूठी
jhuuti	झूठी
joothi	झूठी
tasalli	तसल्ली
tasallii	तसल्ली
iktiyaar	इख्तियार
ikhtiyaar	इख्तियार
ikhtaiyaar	इख्तियार
gadi	घड़ी
ghar	घड़ी
gai	घड़ी
gari	घड़ी
satati	सताती
sataati	सताती
sataatee	सताती
satavati	सताती
satavti	सताती
jaake	जाके
jake	जाके
aaun	आऊँ
aaoo	आऊँ
aaon	आऊँ
bolti	बोलती
bolati	बोलती
bolatee	बोलती
bolatii	बोलती
dhadkna	धड़कना
dhadakna	धड़कना
dhadkana	धड़कना
sikhaaya	सिखाया
sikhaya	सिखाया
sikhaayaa	सिखाया
sikaya	सिखाया
bechainiyaan	बेचैनियां
pyaase	प्यासे
tadapna	तड़पना
tadapana	तड़पना
tadapanaa	तड़पना
thadapna	तड़पना
badata	बढ़ाता
badhaata	बढ़ाता
badhata	बढ़ाता
zindagani	ज़िंदगानी
zindagaani	ज़िंदगानी
zindgaani	ज़िंदगानी
zindagaanii	ज़िंदगानी
zindgani	ज़िंदगानी
zindagaaniya	ज़िंदगानी
jindagani	ज़िंदगानी
jindegani	ज़िंदगानी
khayalon	खयालों
khayaalon	खयालों
khayaloon	खयालों
aata	आता
aataa	आता
ata	आता
ahta	आता
chhayi	छाई
chhaai	छाई
chhai	छाई
chaayi	छाई
chaai	छाई
chayi	छाई
chali	छाई
chai	छाई
aapne	आपने
aapane	आपने
udaya	उड़ाया
udaaya	उड़ाया
churayi	चुराई
churaai	चुराई
churaayi	चुराई
churaaii	चुराई
khota	खोता
khotaa	खोता
banayi	बनाई
banaai	बनाई
banaayi	बनाई
banai	बनाई
banaaii	बनाई
buraai	बुराई
burayi	बुराई
buraayi	बुराई
buraaii	बुराई
chhupai	छुपाई
chhupaai	छुपाई
chhupaayi	छुपाई
churaana	चुराना
churaanaa	चुराना
churana	चुराना
jalaana	जलाना
jalana	जलाना
jalaanaa	जलाना
haseenon	हसीनों
haseeno	हसीनों
hasiinon	हसीनों
hasinon	हसीनों
haseenoon	हसीनों
nishaana	निशाना
nishaanaa	निशाना
nishana	निशाना
baheki	बहकी
behki	बहकी
bahaki	बहकी
bahakii	बहकी
behaki	बहकी
bahki	बहकी
beheki	बहकी
bhekhi	बहकी
chhaane	छाने
chhane	छाने
chaane	छाने
chaahne	छाने
chane	छाने
laali	लाली
laalii	लाली
lali	लाली
lalli	लाली
laalee	लाली
soorat	सूरत
surat	सूरत
suurat	सूरत
suurata	सूरत
surath	सूरत
ay	आय
aye	आय
aay	आय
sharmaaye	शरमाये
sharamaaye	शरमाये
sharmaye	शरमाये
dikhlaaye	दिखलाय
dikhlaye	दिखलाय
chhup	छुप
chup	छुप
chupp	छुप
chhop	छुप
jaaye	जाय
jaay	जाय
bikhraaye	बिखराये
bikhrayee	बिखराये
bikharaaye	बिखराये
chaaha	चाहा
chaha	चाहा
chaahaa	चाहा
uthaaye	उठाये
uthaye	उठाये
utaaye	उठाये
uthhaye	उठाये
uske	उसके
usake	उसके
usske	उसके
uski	उसके
ang	अंग
aang	अंग
anga	अंग
banaaye	बनाये
banaye	बनाये
hazaaron	हज़ारों
hazaro	हज़ारों
hazaron	हज़ारों
hajaaro	हज़ारों
hazaroon	हज़ारों
laayi	लायी
laaye	लायी
layi	लायी
layee	लायी
laayee	लायी
kiran	किरण
sitaaron	सितारों
sitaron	सितारों
sitaaro	सितारों
sitaro	सितारों
chalke	छलके
chalake	छलके
chhalke	छलके
paimaane	पैमाने
rangath	रंगत
rangat	रंगत
shair	शायर
shaayar	शायर
shayar	शायर
sheron	शेरों
shero	शेरों
nagmagar	नग़मागर
tumhe	तुम्हे
lagatee	लगतीं
tumhaaree	तुम्हारी
tumhaari	तुम्हारी
tumhaarii	तुम्हारी
tumhari	तुम्हारी
tumhaare	तुम्हारी
thumhaari	तुम्हारी
tumahaari	तुम्हारी
tumhare	तुम्हारी
dekhoo	देखूँ
dekhun	देखूँ
dekhuun	देखूँ
dekhon	देखूँ
laanaa	लाना
laana	लाना
lana	लाना
rahate	रहतें
udaasee	उदासी
udaasi	उदासी
udasi	उदासी
saaye	साये
saye	साये
saanyi	साये
unche	ऊँचे
makaanon	मकानों
makaano	मकानों
suna	सुना
sunaa	सुना
gali	गली
galii	गली
gale	गली
gile	गली
hey	है
hoy	है
hay	है
aawaaz	आवाज़
aavaaz	आवाज़
aawaz	आवाज़
aavaz	आवाज़
awaaz	आवाज़
avaz	आवाज़
avaaz	आवाज़
awaz	आवाज़
jispe	जिसपे
jisape	जिसपे
mite	मिटे
mitte	मिटे
gila	गिला
gilaa	गिला
usne	उसने
usane	उसने
ghode	घोड़े
haathi	हाथी
dum	दुम
dhum	दुम
hansti	हँसती
hansati	हँसती
hasti	हँसती
hansatii	हँसती
baarish	बारिश
barish	बारिश
ladka	लड़का
ladaka	लड़का
ladakaa	लड़का
gaata	गाता
gaataa	गाता
gata	गाता
baithen	बैठें
baithein	बैठें
bolna	बोलना
bolana	बोलना
bolein	बोलें
bolen	बोलें
bole	बोलें
dholna	ढोलना
dholana	ढोलना
dolna	ढोलना
kholna	खोलना
kholana	खोलना
meelon	मीलों
milon	मीलों
millo	मीलों
milo	मीलों
dolna	डोलना
dolana	डोलना
dholna	डोलना
jeet	जीत
jit	जीत
jiit	जीत
jita	जीत
jeete	जीत
jeeta	जीत
labhon	लबों
labon	लबों
laboo	लबों
labo	लबों
labonn	लबों
chhodna	छोड़ना
chhodana	छोड़ना
chhodanaa	छोड़ना
chodana	छोड़ना
tukde	टुकड़े
tukade	टुकड़े
radha	राधा
raadha	राधा
raadhaa	राधा
shyam	श्याम
shyaam	श्याम
shaam	श्याम
bichhadte	बिछड़ते
bichadte	बिछड़ते
bichhadate	बिछड़ते
armaan	अरमान
aramaan	अरमान
araman	अरमान
arman	अरमान
faisla	फ़ैसला
faislaa	फ़ैसला
faisalaa	फ़ैसला
faisala	फ़ैसला
maangein	मांगें
maangen	मांगें
maange	मांगें
soche	सोचे
doli	डोली
dolii	डोली
dholki	डोली
bikhri	बिखरी
bikhari	बिखरी
bihkri	बिखरी
dekhenge	देखेंगे
dekhengey	देखेंगे
dekheinge	देखेंगे
poochhenge	पूछेंगे
puuchhenge	पूछेंगे
puchhenge	पूछेंगे
ehsaan	एहसान
ehasaan	एहसान
yehasaan	एहसान
ahsaan	एहसान
bhuje	बुझे
bhuj	बुझे
bujhe	बुझे
bujhey	बुझे
buze	बुझे
faisale	फ़ैसले
faisle	फ़ैसले
mili	मिली
milii	मिली
milee	मिली
mile	मिली
milke	मिली
samajhaane	समझाने
samjhane	समझाने
pahare	पहरे
pahren	पहरे
pehre	पहरे
pehare	पहरे
pahere	पहरे
pahre	पहरे
phere	पहरे
jalane	जलने
jalne	जलने
hasarat	हसरत
hasrat	हसरत
husrat	हसरत
hasrath	हसरत
paravaane	परवाने
parwaane	परवाने
parvaane	परवाने
parawaane	परवाने
parawane	परवाने
parwane	परवाने
uthi	उठी
uthii	उठी
uthhi	उठी
aae	आए
aye	आए
ae	आए
are	आए
daastaan	दास्तां
daasataa	दास्तां
dastaan	दास्तां
daastaa	दास्तां
dastan	दास्तां
daastan	दास्तां
aajaate	आजाते
yahin	यहीं
yahee	यहीं
yaheen	यहीं
yahiin	यहीं
bahaaren	बहारें
bahaare	बहारें
bahaarein	बहारें
baharein	बहारें
baharen	बहारें
javaan	जवाँ
jawaan	जवाँ
javan	जवाँ
jawaa	जवाँ
jawan	जवाँ
jeevan	जवाँ
haaye	हाये
haye	हाये
pahalese	पहलेसे
gayi	गयी
gayii	गयी
tanahaaiyaan	तनहाइयाँ
tanhaaiyaan	तनहाइयाँ
tanhaaiyan	तनहाइयाँ
tanahaayiyaan	तनहाइयाँ
parachhaaiyaan	परछाइयाँ
parachhaeeyaan	परछाइयाँ
parchhaaiyaan	परछाइयाँ
badhate	बढ़ते
badhte	बढ़ते
badthe	बढ़ते
badte	बढ़ते
maayusiyon	मायूसियों
milenge	मिलेंगे
milengey	मिलेंगे
paiyaan	पैयाँ
paiyyan	पैयाँ
paiyyaa	पैयाँ
padun	पड़ूँ
paduun	पड़ूँ
padoo	पड़ूँ
binati	बिनती
binatii	बिनती
binti	बिनती
karun	करूँ
karoon	करूँ
karoo	करूँ
karuun	करूँ
karon	करूँ
parades	परदेस
pardes	परदेस
naahiin	नाहीं
naahin	नाहीं
nahi	नाहीं
naaheen	नाहीं
naahi	नाहीं
milegi	मिलेगी
milegii	मिलेगी
milengi	मिलेगी
prem	प्रेम
parem	प्रेम
praem	प्रेम
saanchi	साँची
kahun	कहूँ
kahoon	कहूँ
kahuun	कहूँ
kahoo	कहूँ
khoya	कहूँ
kahon	कहूँ
saiyaan	सैयाँ
saiyyan	सैयाँ
saiyya	सैयाँ
saiyyaa	सैयाँ
anaadi	अनाड़ी
anadi	अनाड़ी
anaadii	अनाड़ी
mose	मोसे
pritam	प्रीतम
preetam	प्रीतम
priitam	प्रीतम
prem	प्रीतम
pareetam	प्रीतम
jiyarava	जियरवा
jiyaravaa	जियरवा
tose	तोसे
haari	हारी
haarii	हारी
haaree	हारी
hari	हारी
haare	हारी
bolungi	बोलूँगी
boloongi	बोलूँगी
boluungi	बोलूँगी
deepak	दीपक
diipak	दीपक
dipak	दीपक
dipaka	दीपक
hamasi	हमसी
mohaniya	मोहनिया
paaoge	पाओगे
paoge	पाओगे
paayoge	पाओगे
gore	गोरे
gaal	गाल
gal	गाल
til	तिल
till	तिल
sajaniya	सजनिया
sajaniyaa	सजनिया
sajanniya	सजनिया
nasib	नसीब
naseeb	नसीब
nasiba	नसीब
hisse	हिस्से
bekasi	बेकसी
kaaravaan	कारवां
karvaan	कारवां
kaarwaan	कारवां
kaarawaan	कारवां
makaam	मकाम
bhulaane	भुलाने
bhulane	भुलाने
koshishen	कोशिशें
koshishein	कोशिशें
tamaam	तमाम
tamam	तमाम
naakaam	नाकाम
nakaam	नाकाम
nakam	नाकाम
naakam	नाकाम
zubaan	ज़ुबाँ
zuban	ज़ुबाँ
manzilein	मंज़िलें
manzilen	मंज़िलें
manzile	मंज़िलें
zikr	ज़िक्र
zikar	ज़िक्र
gardishon	गर्दिशों
sitaaraa	सितारा
sitaara	सितारा
sitara	सितारा
kinaaraa	किनारा
kinaara	किनारा
kinara	किनारा
haaraa	हारा
haara	हारा
hara	हारा
sakaa	सका
saka	सका
gamon	ग़मों
dagamagaayi	डगमगायी
kashti	कश्ती
kashtii	कश्ती
paale	पाले
mitanevaale	मिटनेवाले
praani	प्रानी
darapan	दरपन
darpan	दरपन
karam	करम
karm	करम
bande	बन्दे
achchhe	अच्छे
achche	अच्छे
acchhe	अच्छे
kapat	कपट
sainya	सैंया
sainyaa	सैंया
jude	जुड़े
mel	मेल
mail	मेल
mael	मेल
paauun	पाऊँ
paaun	पाऊँ
paayuun	पाऊँ
paaoon	पाऊँ
paun	पाऊँ
paayun	पाऊँ
paoon	पाऊँ
pao	पाऊँ
paaon	पाऊँ
paaoo	पाऊँ
piya	पीया
peeya	पीया
piyaa	पीया
piiyaa	पीया
jiya	जीया
jiiyaa	जीया
jiyaa	जीया
jeeya	जीया
haae	हाए
haaye	हाए
haay	हाए
haye	हाए
murajhaai	मुरझाई
murajhaayi	मुरझाई
papiha	पपीहा
papihaa	पपीहा
papeeha	पपीहा
papiihaa	पपीहा
papiiha	पपीहा
papeehaa	पपीहा
dooba	डूबा
duba	डूबा
duubaa	डूबा
doobaa	डूबा
duuba	डूबा
dhuba	डूबा
praanon	प्रानों
sanwariya	संवरिया
sanwariyaa	संवरिया
sawariya	संवरिया
sanvariya	संवरिया
naata	नाता
natha	नाता
naataa	नाता
sandes	संदेस
musakaane	मुसकाने
bhes	भेस
bansi	बंसी
bansee	बंसी
bansii	बंसी
zaalim	ज़ालिम
zalim	ज़ालिम
zaleem	ज़ालिम
jaalim	ज़ालिम
jalim	ज़ालिम
chhuda	छुड़ा
chhudaa	छुड़ा
chuda	छुड़ा
a	आ
dinon	दिनों
dino	दिनों
dinoh	दिनों
nagamein	नगमें
nagamen	नगमें
nagmein	नगमें
naghamen	नगमें
qasam	क़सम
barabaadiyon	बरबादियों
barbaadiyon	बरबादियों
tadapoge	तड़पोगे
fariyaad	फ़रियाद
faryaad	फ़रियाद
farayaad	फ़रियाद
fariyad	फ़रियाद
aayengi	आयेंगी
aayegi	आयेंगी
aayengii	आयेंगी
uthengi	उठेंगी
bhuli	भूली
bhuuli	भूली
basaayaa	बसाया
basaaya	बसाया
basaya	बसाया
sukun	सुकूँ
sukuun	सुकूँ
sukoon	सुकूँ
majbooriyaan	मजबूरियाँ
majabuuriyaan	मजबूरियाँ
majaburiyaan	मजबूरियाँ
majburiyan	मजबूरियाँ
majabooriyaan	मजबूरियाँ
majbooriyan	मजबूरियाँ
majbooriya	मजबूरियाँ
dooriyaan	दूरियाँ
duriyaan	दूरियाँ
dooriyann	दूरियाँ
dooriyan	दूरियाँ
duuriyaan	दूरियाँ
duriyan	दूरियाँ
dooriya	दूरियाँ
andhere	अँधेरे
taara	तारा
taaraa	तारा
tara	तारा
dikhalaata	दिखलाता
dikhalaataa	दिखलाता
dikhalata	दिखलाता
ummidon	उम्मीदों
ummiidon	उम्मीदों
ummeedon	उम्मीदों
ummiido	उम्मीदों
ummeedo	उम्मीदों
ummedo	उम्मीदों
jalegi	जलेगी
laage	लागे
lage	लागे
iraade	इरादे
irade	इरादे
tadapat	तड़पत
tadpat	तड़पत
bisaraai	बिसराई
bisaraayi	बिसराई
laaj	लाज
laj	लाज
laaz	लाज
harjaai	हरजाई
harajaai	हरजाई
harajaayi	हरजाई
harjaayi	हरजाई
harajaaii	हरजाई
harzai	हरजाई
paraae	पराए
paraaye	पराए
jhilamil	झिलमिल
jhilmil	झिलमिल
utar	उतर
soya	सोया
soyaa	सोया
pipal	पीपल
peepal	पीपल
piipal	पीपल
tale	तले
ranga	रंगा
laadala	लाडला
ajab	अजब
tori	तोरी
toree	तोरी
torii	तोरी
raama	रामा
rama	रामा
raamaa	रामा
dekhi	देखी
dekhii	देखी
gazab	गज़ब
bulabuliya	बुलबुलिया
huliya	हुलिया
maano	मानो
mano	मानो
parabat	परबत
parbat	परबत
paate	पाटे
mahal	महल
mahel	महल
mehal	महल
mehel	महल
mahala	महल
laharaai	लहराई
laharaayi	लहराई
leharaayi	लहराई
laharaaii	लहराई
lahraai	लहराई
lehraai	लहराई
laharai	लहराई
lehraayi	लहराई
lehrai	लहराई
lehrayi	लहराई
leharaai	लहराई
khilaaen	खिलाए
khilaaye	खिलाए
khilaae	खिलाए
daya	दया
dayaa	दया
bikata	बिकता
bikataa	बिकता
bikta	बिकता
lagaaen	लगाएँ
lagaaye	लगाएँ
lagaayen	लगाएँ
lagaayein	लगाएँ
boli	बोली
bolii	बोली
bole	बोली
bolee	बोली
jaison	जैसों
jholi	झोली
jholii	झोली
bandon	बन्दों
bike	बिके
ganga	गंगा
gangaa	गंगा
jamuna	जमुना
jamunaa	जमुना
gahari	गहरी
gaihri	गहरी
gehri	गहरी
dhaar	धार
dhar	धार
pukaar	पुकार
pukar	पुकार
pukaara	पुकार
bij	बीज
beej	बीज
bichha	बिछा
bichhaa	बिछा
bicha	बिछा
nishaani	निशानी
nishani	निशानी
nishaanii	निशानी
nishanii	निशानी
kaliyon	कलियों
kaliyo	कलियों
bichhaaye	बिछाये
bichhaye	बिछाये
bichaaye	बिछाये
bichayen	बिछाये
daali	डाली
daalii	डाली
dali	डाली
daaali	डाली
taraane	तराने
tarane	तराने
murajhaaye	मुरझाये
pavaniya	पवनिया
pawaniya	पवनिया
son	सों
shon	सों
najariya	नजरिया
nazariya	नजरिया
najariyaa	नजरिया
gaagariya	गागरिया
gaagareeyaa	गागरिया
nagariya	नगरिया
nagariyaa	नगरिया
nagriyaan	नगरिया
bujhegi	बुझेगी
bhujegi	बुझेगी
aavein	आवें
saanvariya	साँवरिया
saanvariyaa	साँवरिया
sanwariya	साँवरिया
saanwariya	साँवरिया
savariya	साँवरिया
saanwariyaan	साँवरिया
saawariya	साँवरिया
saavariyaa	साँवरिया
saawareeyaa	साँवरिया
saawareeyaan	साँवरिया
jalaaye	जलाये
jalayee	जलाये
jalaye	जलाये
chhodi	छोड़ी
chodi	छोड़ी
chhodhi	छोड़ी
sakhiyaan	सखियाँ
maarengi	मारेंगी
taane	ताने
mohe	मोहे
maari	मारी
maaree	मारी
mari	मारी
maarii	मारी
marzi	मारी
jaaegi	जाएगी
jaayegi	जाएगी
jayegi	जाएगी
jaayegee	जाएगी
jaaegii	जाएगी
jaaygi	जाएगी
jaegi	जाएगी
jaayengi	जाएगी
baavariya	बावरिया
baawariyaa	बावरिया
baavariyaa	बावरिया
bavariyaa	बावरिया
lak	लक
tunu	तुनु
os	ओस
hoke	होके
saans	सांस
saas	सांस
jahar	जहर
zaher	जहर
jehar	जहर
zeher	जहर
pine	पीने
piine	पीने
peene	पीने
hansana	हँसना
hasna	हँसना
hasana	हँसना
hansanaa	हँसना
hansna	हँसना
lukana	लुकना
chhupana	छुपना
chupana	छुपना
chupna	छुपना
chhupanaa	छुपना
hod	होड़
khulake	खुलके
khulke	खुलके
laharaati	लहराती
lehraati	लहराती
lahraati	लहराती
laharaatee	लहराती
bainyaan	बैंयां
baiyan	बैंयां
taal	ताल
tal	ताल
dol	डोल
kaanon	कानों
kaano	कानों
kanhon	कानों
kanon	कानों
bol	बोल
bola	बोल
bole	बोल
bolu	बोल
bhoole	बोल
bolo	बोल
rasiya	रसिया
rasiyaa	रसिया
lobhi	लोभी
matalab	मतलब
matlab	मतलब
mathlab	मतलब
neh	नेह
lagaana	लगाना
lagana	लगाना
lagaanaa	लगाना
sahal	सहल
nibhaana	निभाना
nibhaanaa	निभाना
nibhana	निभाना
naazon	नाज़ों
naajon	नाज़ों
muqaddar	मुक़द्दर
muqadar	मुक़द्दर
azmana	आजमाना
aajmaana	आजमाना
aazmaana	आजमाना
azamana	आजमाना
chahta	चाहता
chahata	चाहता
chaahataa	चाहता
chaahta	चाहता
chaahata	चाहता
chahataa	चाहता
banana	बनाना
banaana	बनाना
banaanaa	बनाना
bahana	बनाना
milao	मिलाओ
milaao	मिलाओ
sunana	सुनाना
sunaana	सुनाना
sunaanaa	सुनाना
ashiyana	आशियाना
aashiyana	आशियाना
aashiyaanaa	आशियाना
ashiana	आशियाना
aashiyaana	आशियाना
aashiana	आशियाना
tanhaa	तनहा
tanaha	तनहा
tanha	तनहा
tanahaa	तनहा
aksar	अक्सर
hamdam	हमदम
hamadam	हमदम
humdam	हमदम
humdum	हमदम
humadam	हमदम
besabab	बेसबब
haadase	हादसे
bankar	बनकर
banakar	बनकर
khuddaariyon	ख़ुद्दारियों
bithaake	बिठाके
baalon	बालों
baalo	बालों
siya	सिया
siyaa	सिया
khilo	खिलो
lade	लड़े
chadhe	चढ़े
bindiya	बिंदिया
bindiyaa	बिंदिया
bindia	बिंदिया
hanse	हंसे
darpan	दर्पन
utaar	उतार
mulaaqaat	मुलाक़ात
mulaqaat	मुलाक़ात
mulaqat	मुलाक़ात
beet	बीत
biit	बीत
bit	बीत
bhee	बीत
iqaraar	इक़रार
iqraar	इक़रार
daal	डाल
dalu	डाल
dal	डाल
daala	डाल
khilne	खिलने
khilane	खिलने
lahara	लहरा
laharaa	लहरा
lahra	लहरा
lehra	लहरा
lehara	लहरा
lahraa	लहरा
pare	परे
pad	पड़
balam	बालाम
baalam	बालाम
sataaye	सताये
sataye	सताये
purani	पुरानी
puraani	पुरानी
puraanee	पुरानी
puraanii	पुरानी
poorani	पुरानी
bharose	भरोसे
nazadeekiyaan	नज़दीकियाँ
nazdikiyan	नज़दीकियाँ
nazdikiyaan	नज़दीकियाँ
daaleen	डालीं
mili	मिलीं
miliin	मिलीं
milin	मिलीं
mileen	मिलीं
milii	मिलीं
raahen	राहें
raahein	राहें
raahe	राहें
rahe	राहें
rahein	राहें
rahen	राहें
ulfat	उल्फ़त
ulafat	उल्फ़त
fizaayen	फ़िज़ाएँ
fizaaein	फ़िज़ाएँ
fizaayein	फ़िज़ाएँ
saaye	साए
saae	साए
saye	साए
milakar	मिलकर
milakara	मिलकर
milkar	मिलकर
vaadiyaan	वादियाँ
waadiyaan	वादियाँ
waadiyaa	वादियाँ
wadiyan	वादियाँ
ummeed	उम्मीद
ummid	उम्मीद
ummiid	उम्मीद
ummed	उम्मीद
jisako	जिसको
jisko	जिसको
puraane	पुराने
purane	पुराने
bastiyaan	बस्तियाँ
badha	बढ़ा
bada	बढ़ा
badhaa	बढ़ा
luta	लुटा
lutaa	लुटा
jhuka	झुका
jhukaa	झुका
jala	जला
jalaa	जला
jaala	जला
chhupaaye	छुपाये
chupaye	छुपाये
chupaaye	छुपाये
chhupaye	छुपाये
saki	सकी
sakii	सकी
rok	रोक
rokle	रोक
rokh	रोक
rook	रोक
nashtar	नश्तर
chubh	चुभ
chub	चुभ
gamr	गमर्
retii	रेती
reti	रेती
naazuk	नाज़ुक
nazuk	नाज़ुक
najuk	नाज़ुक
naajuk	नाज़ुक
padenge	पड़ेंगे
padhenge	पड़ेंगे
maujon	मौजों
maujo	मौजों
milegaa	मिलेगा
milega	मिलेगा
milenga	मिलेगा
raag	राग
rag	राग
bezabaan	बेज़बाँ
lut	लुट
luta	लुट
behalaana	बहलाना
bahalaana	बहलाना
behlaana	बहलाना
behelana	बहलाना
aavo	आवो
aao	आवो
jaavo	जावो
sataana	सताना
sataanaa	सताना
satana	सताना
rulaana	रुलाना
rulana	रुलाना
sunaaye	सुनाये
sunaye	सुनाये
khil	खिल
khila	खिल
bulbul	बुलबुल
bulabul	बुलबुल
khelen	खेलें
khelein	खेलें
khele	खेलें
micholi	मिचोली
toli	टोली
tolii	टोली
bolat	बोलत
likhe	लिखे
mita	मिटा
mitaa	मिटा
sake	सके
zakm	ज़ख़्म
zakhm	ज़ख़्म
zakham	ज़ख़्म
raaz	राज
raaj	राज
raja	राज
raj	राज
raaja	राज
rota	रोता
rotaa	रोता
rotha	रोता
waar	वार
vaar	वार
war	वार
naasoor	नासूर
naasuur	नासूर
pehachaan	पहचान
pehchaan	पहचान
pahachaan	पहचान
pahechaan	पहचान
pehchan	पहचान
pehchhaan	पहचान
pahchaan	पहचान
pehchhan	पहचान
pehechaan	पहचान
pahachaana	पहचान
pehechan	पहचान
ponch	पोंछ
ponchh	पोंछ
shikava	शिकवा
shikvaa	शिकवा
shikawa	शिकवा
shikavaa	शिकवा
shikawaa	शिकवा
shikwa	शिकवा
shikva	शिकवा
shikwaa	शिकवा
baaje	बाजे
bajane	बाजे
baje	बाजे
chamakaana	चमकाना
aaja	आजा
aajaa	आजा
aja	आजा
ghole	घोले
dole	डोले
dhole	डोले
dolle	डोले
bhagwan	भगवान
bhagavaan	भगवान
bhagawaan	भगवान
bhagvaan	भगवान
bhagwaan	भगवान
anjaan	अन्जान
anajaan	अन्जान
baap	बाप
baapu	बाप
vidhaata	विधाता
vidhaataa	विधाता
widhaataa	विधाता
jinse	जिनसे
jinase	जिनसे
thamkar	थामकर
kaandhe	कांधे
baithke	बैठके
upkaar	उपकार
upakaar	उपकार
upkar	उपकार
bataana	बताना
bataanaa	बताना
batana	बताना
santaan	संतान
loriyan	लोरियां
loriyaan	लोरियां
bunti	बुनती
bunati	बुनती
prabhu	प्रभू
prabhuu	प्रभू
aapse	आपसे
aapase	आपसे
vardaan	वरदान
varadaan	वरदान
wardaan	वरदान
waradaan	वरदान
vardan	वरदान
hokar	होकर
param	परम
prarthna	प्रार्थना
praarthana	प्रार्थना
praarthanaa	प्रार्थना
chhaya	छाया
chhaayaa	छाया
chhaaya	छाया
chaya	छाया
chaaya	छाया
chahya	छाया
rehti	रहती
rahti	रहती
rahati	रहती
rehati	रहती
rehethi	रहती
rahatii	रहती
raheti	रहती
rehthi	रहती
reheti	रहती
talak	तलक
salaamat	सलामत
salamat	सलामत
salaamata	सलामत
sabke	सबके
sabake	सबके
sabhke	सबके
pehchaane	पहचाने
pahachaane	पहचाने
pehachaane	पहचाने
pahchane	पहचाने
pehchane	पहचाने
pahechaane	पहचाने
hindu	हिन्दू
hinduu	हिन्दू
musalmaan	मुसलमाँ
bujurgon	बुजुर्गों
buzurgon	बुजुर्गों
socho	सोचो
sochon	सोचो
doobe	डूबे
duube	डूबे
dube	डूबे
dubey	डूबे
baantate	बाँटते
saaz	साज़
saaza	साज़
saz	साज़
rahmaan	रहमान
rehman	रहमान
rahamaan	रहमान
kartaar	करतार
karataar	करतार
shahzaadon	शहज़ादों
naitaaon	नेताओं
netaaon	नेताओं
lagaayee	लगाईं
ajantaa	अजन्ता
ajanta	अजन्ता
taaj	ताज
taj	ताज
amar	अमर
amara	अमर
jaani	जानी
jaane	जानी
jaanii	जानी
jani	जानी
zindaa	ज़िन्दा
zinda	ज़िन्दा
jhukaayaa	झुकाया
jhukaaya	झुकाया
jhukaya	झुकाया
inki	इनकी
inaki	इनकी
inakii	इनकी
inke	इनकी
bachaaye	बचाए
bachaye	बचाए
bachaae	बचाए
rangeen	रंगीन
rangin	रंगीन
rangiin	रंगीन
andaaz	अंदाज़
andaz	अंदाज़
karni	करनी
karani	करनी
bevafaai	बेवफ़ाई
bewafaai	बेवफ़ाई
bewafaee	बेवफ़ाई
bewafai	बेवफ़ाई
bewafaayi	बेवफ़ाई
bewafayi	बेवफ़ाई
bevafaaii	बेवफ़ाई
bevafaayi	बेवफ़ाई
duhaai	दुहाई
duhai	दुहाई
duhaayi	दुहाई
duhaaii	दुहाई
duhaiyi	दुहाई
iraadaa	इरादा
iraada	इरादा
yraadaa	इरादा
irada	इरादा
saudaa	सादा
saadha	सादा
saada	सादा
saadaa	सादा
sada	सादा
sadha	सादा
pahchaanane	पहचानने
pahachaanane	पहचानने
maanane	मानने
maanne	मानने
daada	दादा
dada	दादा
guru	गुरू
guruu	गुरू
allaah	अल्लाह
allah	अल्लाह
allaaah	अल्लाह
allaa	अल्लाह
baaba	बाबा
baba	बाबा
baabaa	बाबा
inkaar	इन्कार
daalo	डालो
dalo	डालो
ikdam	इकदम
maangega	मांगेगा
pahuncha	पहुँचा
pahunchaa	पहुँचा
karega	करेगा
karegaa	करेगा
jaadugar	जादूगर
jaaduugar	जादूगर
jadugar	जादूगर
jaadoogar	जादूगर
badhi	बढ़ी
badi	बढ़ी
yaara	यारा
yara	यारा
yaaraan	यारा
yaaraa	यारा
bekraari	बेकरारी
bekaraari	बेकरारी
beqaraari	बेकरारी
bekarari	बेकरारी
bekaaraari	बेकरारी
bekaraarii	बेकरारी
beqaraarii	बेकरारी
dare	डरे
darre	डरे
kahaan	कहां
kahan	कहां
kahaa	कहां
khana	कहां
hamaraahi	हमराही
hamraahi	हमराही
humraahi	हमराही
hamaraahii	हमराही
humrahi	हमराही
hamrahi	हमराही
saara	सार
sotaa	सोता
sota	सोता
soota	सोता
chhutii	छुटी
savere	सवेरे
sawere	सवेरे
saverey	सवेरे
anokhe	अनोखे
uthen	उठें
uthein	उठें
ghabaraaye	घबराये
ghabraye	घबराये
ghabraaye	घबराये
ghabaraye	घबराये
churaaye	चुराये
churaye	चुराये
dukhiyaa	दुखिया
dukhiya	दुखिया
tuutakar	टूटकर
roye	रोये
dhadakanen	धड़कनें
tanahaai	तनहाई
tanhayi	तनहाई
tanhai	तनहाई
tanahaaii	तनहाई
tanhaai	तनहाई
tanhaayi	तनहाई
tanahaayi	तनहाई
chahoge	चाहोगे
chaahoge	चाहोगे
ikraar	इकरार
ikaraar	इकरार
iqaraar	इकरार
iqraar	इकरार
ikrar	इकरार
meherbaani	मेहरबानी
meharabaani	मेहरबानी
meharabaanee	मेहरबानी
meharbani	मेहरबानी
meharbaani	मेहरबानी
meharabaanii	मेहरबानी
meherbani	मेहरबानी
narmi	नर्मी
chhayi	छाईं
chhaain	छाईं
havayein	हवाएं
havaaein	हवाएं
havaaen	हवाएं
hawaein	हवाएं
hawaien	हवाएं
hawayen	हवाएं
hawayein	हवाएं
hawaaein	हवाएं
havaayein	हवाएं
hawaaen	हवाएं
havaayen	हवाएं
hawaayein	हवाएं
hawaayen	हवाएं
havaein	हवाएं
hawaen	हवाएं
beqaabu	बेकाबू
bekaabu	बेकाबू
bekaaboo	बेकाबू
hairaan	हैरान
hairaa	हैरान
hairan	हैरान
surat	सुरत
unhen	उंहें
bulaane	बुलाने
bulane	बुलाने
un	उन
unn	उन
aadaat	आदात
dukhaane	दुखाने
duniyaan	दुनियाँ
duniya	दुनियाँ
duniyaa	दुनियाँ
deedaa	दीदा
didaa	दीदा
tar	तर
pattaa	पत्ता
patta	पत्ता
bootaa	बूटा
boota	बूटा
butaa	बूटा
gunaah	गुनाह
gunaaha	गुनाह
gunah	गुनाह
khaatir	खातिर
khatir	खातिर
gul	गुल
gool	गुल
khilenge	खिलेंगे
khilengey	खिलेंगे
aandhiyaan	आँधियाँ
baandhege	बाँधेंगे
baandhenge	बाँधेंगे
aashiyaan	आशियाँ
aashiyan	आशियाँ
aashiaana	आशियाँ
aashiyaa	आशियाँ
giraye	गिराए
giraaye	गिराए
giraae	गिराए
kaante	काँटे
kante	काँटे
kaate	काँटे
bichhaye	बिछाए
bichaaye	बिछाए
bichhaaye	बिछाए
bichhaae	बिछाए
dikhalaayenge	दिखलाएंगे
dikhlayenge	दिखलाएंगे
dilon	दिलों
dilo	दिलों
dilion	दिलों
aaine	आईने
aayne	आईने
palken	पलकें
palake	पलकें
palke	पलकें
palakein	पलकें
palaken	पलकें
palkein	पलकें
palkain	पलकें
palakee	पलकें
palkhein	पलकें
haya	हया
hayaa	हया
bekararon	बेक़रारों
beqaraaron	बेक़रारों
beqararon	बेक़रारों
dekar	देकर
dardmando	दर्दमन्दों
maange	माँगे
mange	माँगे
bade	बढ़े
badhe	बढ़े
aahon	आहों
banavaari	बनवारी
banawaari	बनवारी
banawaarii	बनवारी
vaalon	वालों
waalon	वालों
waalo	वालों
walo	वालों
walon	वालों
jhuthe	झूठे
jhute	झूठे
kaayaa	काया
kaaya	काया
kaya	काया
giridhar	गिरिधर
ekataaraa	एकतारा
dhaam	धाम
mit	मिट
mita	मिट
charanon	चरणों
charnon	चरणों
charno	चरणों
jagaaye	जगाये
jagaye	जगाये